Constituency No.,Constituency Name,Candidate Name,Party Name,VALID VOTES POLLED in General,VALID VOTES POLLED in Postal,Total Valid Votes,Total Votes,Total Electors,margin
1,Gummidipoondi,GOVINDARAJAN T.J,DMK,125001,1451,126452,222069,280790,50938
1,Gummidipoondi,PRAKASH M,PMK,75004,510,75514,222069,280790,50938
1,Gummidipoondi,USHA,NTK,11643,58,11701,222069,280790,50938
1,Gummidipoondi,DILLIY K.M,DMDK,2553,23,2576,222069,280790,50938
1,Gummidipoondi,NOTA,NOTA,1775,8,1783,222069,280790,50938
1,Gummidipoondi,NAGARAJ S,BSP,1031,7,1038,222069,280790,50938
1,Gummidipoondi,SARAVANAN V,Indiya Jananayaka Katchi,813,3,816,222069,280790,50938
1,Gummidipoondi,SARAVANAN E,IND,526,6,532,222069,280790,50938
1,Gummidipoondi,DEVANATHAN R,IND,482,0,482,222069,280790,50938
1,Gummidipoondi,LAKSHMI R,IND,369,5,374,222069,280790,50938
1,Gummidipoondi,PRAKASH K,IND,349,2,351,222069,280790,50938
1,Gummidipoondi,GOWTHAM J,Anaithu Makkal Arasiyal Katchi,254,0,254,222069,280790,50938
1,Gummidipoondi,PRAKASH M,IND,196,0,196,222069,280790,50938
2,Ponneri,DURAI. CHANDRASEKAR,INC,93669,859,94528,210354,267695,9689
2,Ponneri,BALARAMAN. P,AIADMK,84534,305,84839,210354,267695,9689
2,Ponneri,MAHESWARI. A,NTK,18973,54,19027,210354,267695,9689
2,Ponneri,DESINGURAJAN. D,MNM,5372,22,5394,210354,267695,9689
2,Ponneri,PON. RAJA,AMMK,2813,19,2832,210354,267695,9689
2,Ponneri,NOTA,NOTA,1551,3,1554,210354,267695,9689
2,Ponneri,BHAVANI ILAVENIL. J,BSP,1102,4,1106,210354,267695,9689
2,Ponneri,ASHOK PRIYADARSHAN. S,IND,470,0,470,210354,267695,9689
2,Ponneri,SUGUMAR. K,IND,298,0,298,210354,267695,9689
2,Ponneri,VIJAYAKUMAR. V,Anna MGR Dravida Makkal Kalgam,189,1,190,210354,267695,9689
2,Ponneri,SAMBATH KUMAR.C.H,IND,116,0,116,210354,267695,9689
3,Tiruttani,S.Chandran,DMK,118005,2309,120314,232624,290454,29253
3,Tiruttani,G.Hari,AIADMK,89704,1357,91061,232624,290454,29253
3,Tiruttani,L.AKILA,NTK,11900,107,12007,232624,290454,29253
3,Tiruttani,D.Krishnamoorthi,DMDK,3903,25,3928,232624,290454,29253
3,Tiruttani,NOTA,NOTA,1653,12,1665,232624,290454,29253
3,Tiruttani,D.PAULRAJ,IND,886,3,889,232624,290454,29253
3,Tiruttani,V.P.Vijayan,IND,760,8,768,232624,290454,29253
3,Tiruttani,N.MAGENDIRAN,BSP,711,6,717,232624,290454,29253
3,Tiruttani,M.Hari,IND,365,1,366,232624,290454,29253
3,Tiruttani,M.D.Thanigai Malai,Indiya Jananayaka Katchi,352,1,353,232624,290454,29253
3,Tiruttani,A.J.Suresh,IND,174,8,182,232624,290454,29253
3,Tiruttani,Shettu,IND,147,0,147,232624,290454,29253
3,Tiruttani,Manikkam,All India Jananayaka Makkal Kazhagam,121,0,121,232624,290454,29253
3,Tiruttani,Chandran,IND,59,1,60,232624,290454,29253
3,Tiruttani,Chandran,IND,46,0,46,232624,290454,29253
4,Thiruvallur,"RAAJENDRAN, V.G.",DMK,106316,1393,107709,214243,274781,22701
4,Thiruvallur,"RAMANAH, BE VEE",AIADMK,84508,500,85008,214243,274781,22701
4,Thiruvallur,"PASUPATHY, P.",NTK,14943,85,15028,214243,274781,22701
4,Thiruvallur,"DOSS, D.",BSP,2314,15,2329,214243,274781,22701
4,Thiruvallur,NOTA,NOTA,1857,15,1872,214243,274781,22701
4,Thiruvallur,"GURU, N.",AMMK,1072,5,1077,214243,274781,22701
4,Thiruvallur,"RAJENDIRAN, G.",IND,385,3,388,214243,274781,22701
4,Thiruvallur,"REVATHI, R.",IND,281,2,283,214243,274781,22701
4,Thiruvallur,"BALA KRISHNAN, N.",IND,232,0,232,214243,274781,22701
4,Thiruvallur,"KUMAR, E.",IND,132,1,133,214243,274781,22701
4,Thiruvallur,"RAMANAN, R.",IND,97,0,97,214243,274781,22701
4,Thiruvallur,"SASIKUMAR, J.",IND,87,0,87,214243,274781,22701
5,Poonamallee,Krishnaswamy A,DMK,148383,1195,149578,263736,357879,94110
5,Poonamallee,Rajamannar S X,PMK,55249,219,55468,263736,357879,94110
5,Poonamallee,Manimekalai A,NTK,29804,67,29871,263736,357879,94110
5,Poonamallee,Revathi Manimegalai J,MNM,11877,50,11927,263736,357879,94110
5,Poonamallee,Elumalai T.A.,AMMK,8771,34,8805,263736,357879,94110
5,Poonamallee,Sathyamurthy A C,BSP,2880,11,2891,263736,357879,94110
5,Poonamallee,NOTA,NOTA,2849,18,2867,263736,357879,94110
5,Poonamallee,Ravikumar M,IND,448,0,448,263736,357879,94110
5,Poonamallee,Sivakumar S,IND,403,0,403,263736,357879,94110
5,Poonamallee,Velu S,IND,359,0,359,263736,357879,94110
5,Poonamallee,Boshya Gayathri M,My India Party,288,2,290,263736,357879,94110
5,Poonamallee,Rajesh P,IND,241,0,241,263736,357879,94110
5,Poonamallee,Venkatesan J,IND,240,0,240,263736,357879,94110
5,Poonamallee,Purushothaman B,IND,173,2,175,263736,357879,94110
5,Poonamallee,Dhasarathan R,IND,173,0,173,263736,357879,94110
6,Avadi,Nasar S M,DMK,148845,1442,150287,300927,440037,55275
6,Avadi,Pandiarajan K,AIADMK,94331,681,95012,300927,440037,55275
6,Avadi,VIJAYALAKSHMI G,NTK,29953,134,30087,300927,440037,55275
6,Avadi,Udhayakumar V,MNM,16982,110,17092,300927,440037,55275
6,Avadi,NOTA,NOTA,2361,20,2381,300927,440037,55275
6,Avadi,Sankar N M,DMDK,1895,16,1911,300927,440037,55275
6,Avadi,Balasubramanian M,Tamil Nadu Ilangyar Katchi,1251,12,1263,300927,440037,55275
6,Avadi,CHARLES S,BSP,763,10,773,300927,440037,55275
6,Avadi,Pandiarajan G,IND,359,1,360,300927,440037,55275
6,Avadi,Jayakumar P,IND,299,1,300,300927,440037,55275
6,Avadi,Shanavas Khan J,IND,231,0,231,300927,440037,55275
6,Avadi,Nagaraj M,IND,198,0,198,300927,440037,55275
6,Avadi,Dharani K,IND,184,3,187,300927,440037,55275
6,Avadi,Sugumar M,IND,143,0,143,300927,440037,55275
6,Avadi,Banumathi,My India Party,126,1,127,300927,440037,55275
6,Avadi,Raman N,Tamilnadu Makkal Nalvazhvu Periyakkam,120,0,120,300927,440037,55275
6,Avadi,Viswanathan R,MGR Makkal Katchi,108,0,108,300927,440037,55275
6,Avadi,Chandrasekar.A,IND,105,0,105,300927,440037,55275
6,Avadi,Venkatesan M,IND,95,0,95,300927,440037,55275
6,Avadi,Durgaprasad G,IND,73,2,75,300927,440037,55275
6,Avadi,Akilan T.M.,IND,72,0,72,300927,440037,55275
7,Maduravoyal,GANAPATHY.K,DMK,120441,857,121298,273870,448864,31721
7,Maduravoyal,BENJAMIN.P,AIADMK,89313,264,89577,273870,448864,31721
7,Maduravoyal,PADMA PRIYA.S,MNM,33310,91,33401,273870,448864,31721
7,Maduravoyal,GANESHKUMAR.G,NTK,20999,46,21045,273870,448864,31721
7,Maduravoyal,LUCKY MURUGAN.E,AMMK,2648,12,2660,273870,448864,31721
7,Maduravoyal,NOTA,NOTA,2137,9,2146,273870,448864,31721
7,Maduravoyal,SHANMUGAM.K,Tamil Nadu Ilangyar Katchi,906,2,908,273870,448864,31721
7,Maduravoyal,SANTHAKUMAR.Y,BSP,622,6,628,273870,448864,31721
7,Maduravoyal,PRIYA.K,IND,552,1,553,273870,448864,31721
7,Maduravoyal,LAVANYA.P,Nationalist Congress Party,348,1,349,273870,448864,31721
7,Maduravoyal,SELVAKUMAR.V,IND,287,0,287,273870,448864,31721
7,Maduravoyal,MURUGAN.D,IND,161,0,161,273870,448864,31721
7,Maduravoyal,BENJAMIN MOSES.S,IND,149,0,149,273870,448864,31721
7,Maduravoyal,ABARAJITHAN.R,IND,142,1,143,273870,448864,31721
7,Maduravoyal,NEVIS STELLA MARY.B,Anaithu Makkal Arasiyal Katchi,124,0,124,273870,448864,31721
7,Maduravoyal,GANAPATHY.R,IND,96,0,96,273870,448864,31721
7,Maduravoyal,ARUNKUMAR.A,IND,95,0,95,273870,448864,31721
7,Maduravoyal,MUTHURAMAN.S,Anna MGR Dravida Makkal Kalgam,69,0,69,273870,448864,31721
7,Maduravoyal,AMALRAJ.S,IND,69,0,69,273870,448864,31721
7,Maduravoyal,SUMITHRA.R,Bahujan Dravida Party,64,0,64,273870,448864,31721
7,Maduravoyal,RAVI.C.V,IND,48,0,48,273870,448864,31721
8,Ambattur,JOSEPH SAMUEL,DMK,113371,1183,114554,240299,383062,42146
8,Ambattur,V ALEXANDER,AIADMK,71908,500,72408,240299,383062,42146
8,Ambattur,R ANBU THENARASAN,NTK,22638,63,22701,240299,383062,42146
8,Ambattur,S VAITHESWARAN,MNM,22286,84,22370,240299,383062,42146
8,Ambattur,S VEDHACHALAM,AMMK,2616,15,2631,240299,383062,42146
8,Ambattur,NOTA,NOTA,2332,26,2358,240299,383062,42146
8,Ambattur,K Bharathi,IND,801,6,807,240299,383062,42146
8,Ambattur,R Radha,Nationalist Congress Party,613,2,615,240299,383062,42146
8,Ambattur,S Praveen,IND,251,0,251,240299,383062,42146
8,Ambattur,S Veena,Anaithu Makkal Arasiyal Katchi,231,2,233,240299,383062,42146
8,Ambattur,NARMADA NANDHAKUMAR,IND,176,1,177,240299,383062,42146
8,Ambattur,T Joseph Samuvel SanthaKumar,IND,162,0,162,240299,383062,42146
8,Ambattur,T MUNIANDI,IND,156,0,156,240299,383062,42146
8,Ambattur,M S ARUMUGAM,IND,141,1,142,240299,383062,42146
8,Ambattur,C RAGHUL,IND,138,1,139,240299,383062,42146
8,Ambattur,Bharadan,IND,111,0,111,240299,383062,42146
8,Ambattur,A R MURUGAVEL,IND,94,1,95,240299,383062,42146
8,Ambattur,G Soma Sundaram,IND,80,0,80,240299,383062,42146
8,Ambattur,A S Kesavan,IND,59,0,59,240299,383062,42146
8,Ambattur,G Srinivasan,IND,56,1,57,240299,383062,42146
8,Ambattur,N Ganesan,IND,55,0,55,240299,383062,42146
8,Ambattur,P Dhanraj,IND,52,3,55,240299,383062,42146
8,Ambattur,Ravi,IND,44,0,44,240299,383062,42146
8,Ambattur,G Vijayakumar,IND,39,0,39,240299,383062,42146
9,Madavaram,SUDHARSANAM. S,DMK,150654,831,151485,302700,450832,57071
9,Madavaram,Moorthy. V,AIADMK,94206,208,94414,302700,450832,57071
9,Madavaram,ELUMALAI. R,NTK,27411,42,27453,302700,450832,57071
9,Madavaram,RAMESH,MNM,15838,39,15877,302700,450832,57071
9,Madavaram,DHAKSHNAMOORTHY. D,AMMK,7088,16,7104,302700,450832,57071
9,Madavaram,NOTA,NOTA,2161,5,2166,302700,450832,57071
9,Madavaram,DEEPAK. S,BSP,1390,3,1393,302700,450832,57071
9,Madavaram,ARAVIND KUMAR. P,Desiya Makkal Sakthi Katchi,465,0,465,302700,450832,57071
9,Madavaram,MOORTHY. S,IND,437,0,437,302700,450832,57071
9,Madavaram,RAMU. S,IND,431,0,431,302700,450832,57071
9,Madavaram,BABU. M.G,IND,411,2,413,302700,450832,57071
9,Madavaram,SAMBATH. E,Shiv Sena,175,0,175,302700,450832,57071
9,Madavaram,SUDHARSANAN. D,IND,169,1,170,302700,450832,57071
9,Madavaram,JAYASEELAN. S,IND,119,0,119,302700,450832,57071
9,Madavaram,VINOTH KUMAR. M,Naadaalum Makkal Katchi,113,1,114,302700,450832,57071
9,Madavaram,ARIVUNITHI. S,IND,108,0,108,302700,450832,57071
9,Madavaram,NIRMAL KUMAR. M,IND,101,0,101,302700,450832,57071
9,Madavaram,SAKTHIVEL. A,IND,83,2,85,302700,450832,57071
9,Madavaram,YUVARAJ. M,Anna MGR Dravida Makkal Kalgam,81,0,81,302700,450832,57071
9,Madavaram,SATHISH KUMAR. S,IND,62,0,62,302700,450832,57071
9,Madavaram,RAMESH. G,IND,47,0,47,302700,450832,57071
10,Thiruvottiyur,K.P.SHANKAR,DMK,87703,482,88185,199996,304842,37661
10,Thiruvottiyur,K.KUPPAN,AIADMK,50435,89,50524,199996,304842,37661
10,Thiruvottiyur,SEEMAN,NTK,48497,100,48597,199996,304842,37661
10,Thiruvottiyur,D.MOHAN,MNM,7025,28,7053,199996,304842,37661
10,Thiruvottiyur,M.SOUNDARA PANDIAN,AMMK,1413,4,1417,199996,304842,37661
10,Thiruvottiyur,NOTA,NOTA,1106,5,1111,199996,304842,37661
10,Thiruvottiyur,M.A.MICHAEL RAJ,IND,601,2,603,199996,304842,37661
10,Thiruvottiyur,N.RAMESH KUMAR,IND,584,1,585,199996,304842,37661
10,Thiruvottiyur,M.KOTTESWARAN,BSP,367,0,367,199996,304842,37661
10,Thiruvottiyur,D.SASIRAJ,Samata Party,291,0,291,199996,304842,37661
10,Thiruvottiyur,R.EGAVALLI,Naadaalum Makkal Katchi,253,0,253,199996,304842,37661
10,Thiruvottiyur,U.VENKATESH,IND,224,0,224,199996,304842,37661
10,Thiruvottiyur,M.CHELLAM,IND,184,0,184,199996,304842,37661
10,Thiruvottiyur,C.DHANRAJ,IND,115,0,115,199996,304842,37661
10,Thiruvottiyur,D.THAMIZHIZHAN,IND,103,0,103,199996,304842,37661
10,Thiruvottiyur,K.GOPINATH,IND,96,0,96,199996,304842,37661
10,Thiruvottiyur,B.DHANASEKARAN,IND,88,0,88,199996,304842,37661
10,Thiruvottiyur,B.ZAKIR HUSSAIN,IND,71,0,71,199996,304842,37661
10,Thiruvottiyur,PRAVINA,IND,52,0,52,199996,304842,37661
10,Thiruvottiyur,N.RAJESH KUMAR,IND,48,0,48,199996,304842,37661
10,Thiruvottiyur,V.SURESHBALAJI,IND,29,0,29,199996,304842,37661
11,Dr.Radhakrishnan Nagar,EBENEZER. J.J. (@)  JOHN EBENEZER.J,DMK,95516,247,95763,187027,262757,42479
11,Dr.Radhakrishnan Nagar,RAAJESH.R.S.,AIADMK,53204,80,53284,187027,262757,42479
11,Dr.Radhakrishnan Nagar,GOWRISHANKAR . K,NTK,20401,36,20437,187027,262757,42479
11,Dr.Radhakrishnan Nagar,FAZIL . A,MNM,11181,17,11198,187027,262757,42479
11,Dr.Radhakrishnan Nagar,DR. KALIDAS . P,AMMK,1848,4,1852,187027,262757,42479
11,Dr.Radhakrishnan Nagar,NOTA,NOTA,1702,2,1704,187027,262757,42479
11,Dr.Radhakrishnan Nagar,SANTHAKUMAR . A,IND,557,0,557,187027,262757,42479
11,Dr.Radhakrishnan Nagar,VIJAYAN.P,BSP,361,0,361,187027,262757,42479
11,Dr.Radhakrishnan Nagar,SASIDARAN.S,IND,241,0,241,187027,262757,42479
11,Dr.Radhakrishnan Nagar,Daniel Sachin Mani.E,IND,222,0,222,187027,262757,42479
11,Dr.Radhakrishnan Nagar,SIVAKUMAR.S,SOCIALIST UNITY CENTRE OF INDIA (COMMUNIST),214,1,215,187027,262757,42479
11,Dr.Radhakrishnan Nagar,BABU MAILAN . A,Republican Party of India (Athawale),115,0,115,187027,262757,42479
11,Dr.Radhakrishnan Nagar,KANDEEPAN.G,IND,111,0,111,187027,262757,42479
11,Dr.Radhakrishnan Nagar,RAMADASS . E,Makkal Nalvaazhvuk Katchi,104,0,104,187027,262757,42479
11,Dr.Radhakrishnan Nagar,GUNASEKARAN.G,IND,92,0,92,187027,262757,42479
11,Dr.Radhakrishnan Nagar,PREMKUMAR.P,IND,79,0,79,187027,262757,42479
11,Dr.Radhakrishnan Nagar,MOHAN . R,United States of India Party,79,0,79,187027,262757,42479
11,Dr.Radhakrishnan Nagar,KALIDASS,IND,67,0,67,187027,262757,42479
11,Dr.Radhakrishnan Nagar,SRIDHAR . C,IND,55,0,55,187027,262757,42479
11,Dr.Radhakrishnan Nagar,DEVARAJ.M,IND,48,0,48,187027,262757,42479
11,Dr.Radhakrishnan Nagar,DEVAKUMAR.R,IND,48,0,48,187027,262757,42479
11,Dr.Radhakrishnan Nagar,RAJESH . I,IND,47,0,47,187027,262757,42479
11,Dr.Radhakrishnan Nagar,FRANKLIN.D,IND,44,0,44,187027,262757,42479
11,Dr.Radhakrishnan Nagar,PURUSHOTHAMAN . K,IND,44,0,44,187027,262757,42479
11,Dr.Radhakrishnan Nagar,BOOTHIRAJAN.G,IND,39,0,39,187027,262757,42479
11,Dr.Radhakrishnan Nagar,MARIMUTHU.P,IND,38,0,38,187027,262757,42479
11,Dr.Radhakrishnan Nagar,RAJESH . S,IND,36,1,37,187027,262757,42479
11,Dr.Radhakrishnan Nagar,VENKATRAMAN . C,IND,36,1,37,187027,262757,42479
11,Dr.Radhakrishnan Nagar,VENUGOPAL.D,Shiv Sena,32,2,34,187027,262757,42479
11,Dr.Radhakrishnan Nagar,VIVEK.C,IND,27,0,27,187027,262757,42479
11,Dr.Radhakrishnan Nagar,ETHIRAJ.R,IND,26,0,26,187027,262757,42479
11,Dr.Radhakrishnan Nagar,MADHAN RAJ . D,IND,22,0,22,187027,262757,42479
12,Perambur,SHEKAR. R.D,DMK,104580,687,105267,200387,315235,54976
12,Perambur,DHANAPALAN N.R,AIADMK,50093,198,50291,200387,315235,54976
12,Perambur,MERLIN SUGANTHI. S,NTK,19787,34,19821,200387,315235,54976
12,Perambur,PONNUSAMY. A,MNM,17026,46,17072,200387,315235,54976
12,Perambur,LAKSHMI NARAYANAN. E,AMMK,4039,3,4042,200387,315235,54976
12,Perambur,NOTA,NOTA,1508,7,1515,200387,315235,54976
12,Perambur,SURESH. C,BSP,515,0,515,200387,315235,54976
12,Perambur,SOOSAI. M.A,Republican Party of India (Athawale),296,0,296,200387,315235,54976
12,Perambur,SEBASTIN. J,SOCIALIST UNITY CENTRE OF INDIA (COMMUNIST),194,0,194,200387,315235,54976
12,Perambur,SATHEESH. J,IND,174,0,174,200387,315235,54976
12,Perambur,PARTHIPAN. P,IND,172,0,172,200387,315235,54976
12,Perambur,SEKAR. P,IND,166,0,166,200387,315235,54976
12,Perambur,RAJESH. K,IND,163,0,163,200387,315235,54976
12,Perambur,PREM ANAND. J,IND,112,0,112,200387,315235,54976
12,Perambur,SATHISHKUMAR. S,IND,106,0,106,200387,315235,54976
12,Perambur,RAJESH KUMAR. S,IND,90,0,90,200387,315235,54976
12,Perambur,SELVARAJ. R,IND,86,1,87,200387,315235,54976
12,Perambur,SARAVANA PERUMAL. R,IND,65,0,65,200387,315235,54976
12,Perambur,UDAYAKUMAR. S,IND,59,1,60,200387,315235,54976
12,Perambur,KADHIRAVAN. M,IND,48,0,48,200387,315235,54976
12,Perambur,VENKATESH. L,IND,46,0,46,200387,315235,54976
12,Perambur,VINOTHKUMAR. G,IND,45,0,45,200387,315235,54976
12,Perambur,VASANTHA KUMAR. M,IND,40,0,40,200387,315235,54976
13,Kolathur,M.K. STALIN,DMK,104305,1217,105522,173388,282343,70384
13,Kolathur,AADIRAJARAM,AIADMK,34801,337,35138,173388,282343,70384
13,Kolathur,A.JAGADISH KUMAR,MNM,13989,87,14076,173388,282343,70384
13,Kolathur,F.CAMILUS SELVA,NTK,11234,45,11279,173388,282343,70384
13,Kolathur,NOTA,NOTA,1518,11,1529,173388,282343,70384
13,Kolathur,MJS.JAMAL MOHAMED MEERA,BSP,1286,9,1295,173388,282343,70384
13,Kolathur,J.ARUMUGAM,AMMK,1075,5,1080,173388,282343,70384
13,Kolathur,AGNI SRI RAMACHANDRAN,IND,680,1,681,173388,282343,70384
13,Kolathur,SURESH,Tamil Nadu Ilangyar Katchi,619,1,620,173388,282343,70384
13,Kolathur,ASHOK KUMAR.S,New Generation People’s Party,257,0,257,173388,282343,70384
13,Kolathur,AL. NARESH KUMAR,IND,198,0,198,173388,282343,70384
13,Kolathur,DIVYA,IND,180,1,181,173388,282343,70384
13,Kolathur,G.VELMURUGAN,Shiv Sena,130,2,132,173388,282343,70384
13,Kolathur,L.KATHIRESAN,IND,118,0,118,173388,282343,70384
13,Kolathur,VIVEKRAJ.J,Thamizhaga Munnetra Congress,116,0,116,173388,282343,70384
13,Kolathur,J.SURIYAMUTHU,IND,109,1,110,173388,282343,70384
13,Kolathur,MIRZA SAFDAR ALI,IND,97,0,97,173388,282343,70384
13,Kolathur,MALARVIZHI,IND,92,0,92,173388,282343,70384
13,Kolathur,D.SURESHBABU,Desiya Makkal Sakthi Katchi,87,0,87,173388,282343,70384
13,Kolathur,SATHIYASEELAN,IND,86,0,86,173388,282343,70384
13,Kolathur,ELUMALAI.K,Veerath Thiyagi Viswanathadoss Thozhilalarkal Katchi,69,0,69,173388,282343,70384
13,Kolathur,M.RAJENDRAN,National Democratic Party of South India,65,0,65,173388,282343,70384
13,Kolathur,RAMA DEVI,IND,61,0,61,173388,282343,70384
13,Kolathur,C.JEEVAKUMAR,IND,52,0,52,173388,282343,70384
13,Kolathur,D.NILAMANI,IND,44,1,45,173388,282343,70384
13,Kolathur,S.SURESHKUMAR,Makkalatchi Katchi,38,5,43,173388,282343,70384
13,Kolathur,A.SEETHA,Bahujan Dravida Party,41,0,41,173388,282343,70384
13,Kolathur,K. PANNERSELVAM,IND,38,2,40,173388,282343,70384
13,Kolathur,P.SENTHIL KUMAR,IND,38,0,38,173388,282343,70384
13,Kolathur,P.HARISHKUMAR,IND,38,0,38,173388,282343,70384
13,Kolathur,DEVIKARANI,IND,37,0,37,173388,282343,70384
13,Kolathur,R.SELVAM,IND,32,1,33,173388,282343,70384
13,Kolathur,M.A.S. SENTHIL KUMAR,IND,32,1,33,173388,282343,70384
13,Kolathur,E.RAJENDRAN,Anna MGR Dravida Makkal Kalgam,25,5,30,173388,282343,70384
13,Kolathur,NIRMALA DEVI,IND,29,0,29,173388,282343,70384
13,Kolathur,V.SURESHKUMAR,IND,22,0,22,173388,282343,70384
13,Kolathur,B.VIJAYA KUMAR,IND,18,0,18,173388,282343,70384
14,Villivakkam,A . Vetriazhagan,DMK,75347,780,76127,144092,255029,37237
14,Villivakkam,J.C.D.Prabhakar,AIADMK,38601,289,38890,144092,255029,37237
14,Villivakkam,Sriharan,MNM,13282,82,13364,144092,255029,37237
14,Villivakkam,R.Sridar,NTK,10846,68,10914,144092,255029,37237
14,Villivakkam,NOTA,NOTA,1430,14,1444,144092,255029,37237
14,Villivakkam,D.Subamangalam,DMDK,1081,13,1094,144092,255029,37237
14,Villivakkam,Syed Rayhan,IND,409,0,409,144092,255029,37237
14,Villivakkam,Jagadesh Jayakumar,Valamaana  Tamizhagam   Katchi,261,0,261,144092,255029,37237
14,Villivakkam,A.Palanivel,BSP,221,1,222,144092,255029,37237
14,Villivakkam,M.Gunasekaran,IND,206,0,206,144092,255029,37237
14,Villivakkam,S.Chandrika,IND,193,1,194,144092,255029,37237
14,Villivakkam,L.Govindaraj,Nam India Naam Indiyar Katchi,188,1,189,144092,255029,37237
14,Villivakkam,S.Baskar,IND,171,0,171,144092,255029,37237
14,Villivakkam,M.Murali Vinodh,IND,98,0,98,144092,255029,37237
14,Villivakkam,S. Raju Bharathi,Desiya Makkal Sakthi Katchi,88,0,88,144092,255029,37237
14,Villivakkam,A . Ajith Kumar,IND,80,0,80,144092,255029,37237
14,Villivakkam,S.Kandasamy,IND,68,6,74,144092,255029,37237
14,Villivakkam,C.Mohan,IND,54,0,54,144092,255029,37237
14,Villivakkam,M .Jalal,IND,43,0,43,144092,255029,37237
14,Villivakkam,A.S.Kumar,IND,42,0,42,144092,255029,37237
14,Villivakkam,C.A.Ashok Kumar,IND,39,1,40,144092,255029,37237
14,Villivakkam,G.Iyanar,IND,34,2,36,144092,255029,37237
14,Villivakkam,G. Devapriyan,IND,27,0,27,144092,255029,37237
14,Villivakkam,C.Raghul,IND,24,1,25,144092,255029,37237
15,Thiru-Vi-Ka-Nagar,SIVAKUMAR.P,DMK,81283,444,81727,133696,220831,55013
15,Thiru-Vi-Ka-Nagar,KALYANI.P.L,AIADMK,26602,112,26714,133696,220831,55013
15,Thiru-Vi-Ka-Nagar,ILLAVANJI.Dr.R,NTK,10892,29,10921,133696,220831,55013
15,Thiru-Vi-Ka-Nagar,OBATH.S,MNM,9670,40,9710,133696,220831,55013
15,Thiru-Vi-Ka-Nagar,SEKAR.M.P,DMDK,1785,2,1787,133696,220831,55013
15,Thiru-Vi-Ka-Nagar,NOTA,NOTA,1042,4,1046,133696,220831,55013
15,Thiru-Vi-Ka-Nagar,BAGAVATH SINGH.M,BSP,352,3,355,133696,220831,55013
15,Thiru-Vi-Ka-Nagar,SIHAMANI.G,IND,213,1,214,133696,220831,55013
15,Thiru-Vi-Ka-Nagar,SUNDAR.G,IND,144,0,144,133696,220831,55013
15,Thiru-Vi-Ka-Nagar,SELVAKUMAR.A,IND,136,0,136,133696,220831,55013
15,Thiru-Vi-Ka-Nagar,KALYANI.K,IND,128,1,129,133696,220831,55013
15,Thiru-Vi-Ka-Nagar,SEKAR.E,IND,124,1,125,133696,220831,55013
15,Thiru-Vi-Ka-Nagar,RAMESH BABU.M,IND,105,1,106,133696,220831,55013
15,Thiru-Vi-Ka-Nagar,KOLANJI.M,IND,85,0,85,133696,220831,55013
15,Thiru-Vi-Ka-Nagar,PRABHAKARAN.K,Makkalatchi Katchi,78,1,79,133696,220831,55013
15,Thiru-Vi-Ka-Nagar,UDAYA CHANDRAN .R,IND,76,1,77,133696,220831,55013
15,Thiru-Vi-Ka-Nagar,RAVIKUMAR.S,Republican Party of India  (Sivaraj),62,0,62,133696,220831,55013
15,Thiru-Vi-Ka-Nagar,MALATHI.S,IND,57,0,57,133696,220831,55013
15,Thiru-Vi-Ka-Nagar,PREMKUMAR.G,IND,44,0,44,133696,220831,55013
15,Thiru-Vi-Ka-Nagar,RAVIPARAIYANAR.D,Republican Party of India (Athawale),41,0,41,133696,220831,55013
15,Thiru-Vi-Ka-Nagar,SANTHANU.S,IND,38,0,38,133696,220831,55013
15,Thiru-Vi-Ka-Nagar,RANGANATHAN.M,IND,37,0,37,133696,220831,55013
15,Thiru-Vi-Ka-Nagar,GOVINDARAJ.G,IND,33,0,33,133696,220831,55013
15,Thiru-Vi-Ka-Nagar,BIRLABOSE.M,IND,29,0,29,133696,220831,55013
16,Egmore,I.PARANTHAMEN,DMK,68160,672,68832,119271,192283,38768
16,Egmore,B.JOHN PANDIAN,AIADMK,29729,335,30064,119271,192283,38768
16,Egmore,U. PRIYADARSINI,MNM,9933,57,9990,119271,192283,38768
16,Egmore,P.GEETHA LAKSHMI,NTK,6237,39,6276,119271,192283,38768
16,Egmore,T.PRABHU,DMDK,1270,23,1293,119271,192283,38768
16,Egmore,NOTA,NOTA,1167,9,1176,119271,192283,38768
16,Egmore,V. PRABHU,IND,491,1,492,119271,192283,38768
16,Egmore,K.P.SUNDARAPRATHABAN,BSP,357,4,361,119271,192283,38768
16,Egmore,S.JAYAKALPANA,IND,171,0,171,119271,192283,38768
16,Egmore,Dr.N. GUNASEKAR,IND,107,2,109,119271,192283,38768
16,Egmore,A.PARANTHAMAN,IND,98,0,98,119271,192283,38768
16,Egmore,J.CHANDRAKALA,Lok Jan Shakti Party,91,1,92,119271,192283,38768
16,Egmore,G.R.RAJENDRAN,IND,82,2,84,119271,192283,38768
16,Egmore,G.SHEEJA,Nam India Naam Indiyar Katchi,55,0,55,119271,192283,38768
16,Egmore,R.REVANTH,Anaithu Makkal Arasiyal Katchi,45,0,45,119271,192283,38768
16,Egmore,M.UTHAYAKUMAR,IND,39,2,41,119271,192283,38768
16,Egmore,N.ARAVINTH KUMAR,IND,38,0,38,119271,192283,38768
16,Egmore,V.SEKAR,IND,26,2,28,119271,192283,38768
16,Egmore,V.ESWARAN,IND,22,4,26,119271,192283,38768
17,Royapuram,MURTHY.R.IDREAM,DMK,64095,329,64424,121191,191379,27779
17,Royapuram,JAYAKUMAR.D,AIADMK,36458,187,36645,121191,191379,27779
17,Royapuram,GUNASEKARAN.S,MNM,8139,27,8166,121191,191379,27779
17,Royapuram,KAMALI.S,NTK,7923,30,7953,121191,191379,27779
17,Royapuram,RAMAJAYAM.C,AMMK,1124,4,1128,121191,191379,27779
17,Royapuram,NOTA,NOTA,896,5,901,121191,191379,27779
17,Royapuram,JAMES MARTIN.M,Tamil Nadu Ilangyar Katchi,554,3,557,121191,191379,27779
17,Royapuram,SUGANTHAN.T,IND,205,0,205,121191,191379,27779
17,Royapuram,KUMAR.S,BSP,180,0,180,121191,191379,27779
17,Royapuram,MOHAN.A,Tipu Sultan Party,172,0,172,121191,191379,27779
17,Royapuram,SELVAKUMAR.J,IND,133,0,133,121191,191379,27779
17,Royapuram,DHANASEKARAN.G,IND,109,0,109,121191,191379,27779
17,Royapuram,SUBRAMANI.S.N,IND,85,0,85,121191,191379,27779
17,Royapuram,SUNDARAPANDIAN.R,IND,60,0,60,121191,191379,27779
17,Royapuram,PRASATH.K,IND,58,0,58,121191,191379,27779
17,Royapuram,DINAKARAN.S,IND,56,0,56,121191,191379,27779
17,Royapuram,PRABHAKARAN.V,IND,55,0,55,121191,191379,27779
17,Royapuram,GOKUL.G,IND,52,0,52,121191,191379,27779
17,Royapuram,CHELLAPPPAN.T,IND,50,0,50,121191,191379,27779
17,Royapuram,MURTHY.T.C.S,IND,42,1,43,121191,191379,27779
17,Royapuram,SATHISH.S,IND,30,0,30,121191,191379,27779
17,Royapuram,KALIDASS.K.R,IND,27,0,27,121191,191379,27779
17,Royapuram,VELU.G,IND,27,0,27,121191,191379,27779
17,Royapuram,KARUNAKARAN.H,IND,26,0,26,121191,191379,27779
17,Royapuram,KARTHICK.V,IND,21,0,21,121191,191379,27779
17,Royapuram,PRABHU.D,IND,18,0,18,121191,191379,27779
17,Royapuram,VINDHAN.A,IND,10,0,10,121191,191379,27779
18,Harbour,SEKARBABU. P.K,DMK,59073,244,59317,101650,176288,27274
18,Harbour,VINOJ. P. SELVAM,BJP,31971,72,32043,101650,176288,27274
18,Harbour,RAMESH. A,MNM,3758,5,3763,101650,176288,27274
18,Harbour,AHAMED FAZIL. M,NTK,3345,12,3357,101650,176288,27274
18,Harbour,NOTA,NOTA,909,3,912,101650,176288,27274
18,Harbour,SANTHANA KRISHNAN. P,AMMK,771,4,775,101650,176288,27274
18,Harbour,RAVIKUMAR. C,BSP,410,0,410,101650,176288,27274
18,Harbour,SELVAM. P,IND,247,0,247,101650,176288,27274
18,Harbour,VIVEK RAM. A,IND,166,0,166,101650,176288,27274
18,Harbour,SURESH. R,IND,117,0,117,101650,176288,27274
18,Harbour,GANESH. S,IND,68,0,68,101650,176288,27274
18,Harbour,SELVARAJ. S,IND,63,0,63,101650,176288,27274
18,Harbour,KAMAL. J,IND,45,2,47,101650,176288,27274
18,Harbour,SIVARAMAN. G,IND,40,0,40,101650,176288,27274
18,Harbour,SHANKAR. A,IND,37,1,38,101650,176288,27274
18,Harbour,SELVAKUMAR. R,IND,37,0,37,101650,176288,27274
18,Harbour,RAMKI. P,IND,33,0,33,101650,176288,27274
18,Harbour,PUGALENTHI. P,IND,28,0,28,101650,176288,27274
18,Harbour,UDHAYAKUMAR. V,IND,25,0,25,101650,176288,27274
18,Harbour,SRINIVASAN. P,IND,25,0,25,101650,176288,27274
18,Harbour,KRISHNAKUMAR. G,IND,22,0,22,101650,176288,27274
18,Harbour,ANANDRAJ. T.K,IND,21,0,21,101650,176288,27274
18,Harbour,DAMODHARAN. A.G,IND,20,0,20,101650,176288,27274
18,Harbour,ZIONRAJ. M,IND,18,0,18,101650,176288,27274
18,Harbour,CHANDRAN. R,IND,13,0,13,101650,176288,27274
18,Harbour,RAGHUNATH. K,IND,13,0,13,101650,176288,27274
18,Harbour,RAMESH. D,IND,11,1,12,101650,176288,27274
18,Harbour,NAGARAJ. S,IND,10,0,10,101650,176288,27274
18,Harbour,MAHALINGAM. D,IND,10,0,10,101650,176288,27274
19,Chepauk-Thiruvallikeni,UDHAYANIDHI STALIN,DMK,92636,649,93285,137405,234327,69355
19,Chepauk-Thiruvallikeni,KASSALI A.V.A,PMK,23763,167,23930,137405,234327,69355
19,Chepauk-Thiruvallikeni,JAYASIMMARAJA  S M,NTK,9170,23,9193,137405,234327,69355
19,Chepauk-Thiruvallikeni,MOHAMMED IDRIS K,Indiya Jananayaka Katchi,4090,6,4096,137405,234327,69355
19,Chepauk-Thiruvallikeni,NOTA,NOTA,2047,14,2061,137405,234327,69355
19,Chepauk-Thiruvallikeni,RAJENDRAN L,AMMK,1865,8,1873,137405,234327,69355
19,Chepauk-Thiruvallikeni,RAGHU C,BSP,715,8,723,137405,234327,69355
19,Chepauk-Thiruvallikeni,RAVI E,IND,353,14,367,137405,234327,69355
19,Chepauk-Thiruvallikeni,TABREZ,Tipu Sultan Party,366,1,367,137405,234327,69355
19,Chepauk-Thiruvallikeni,SENTHIL KUMAR H,IND,244,0,244,137405,234327,69355
19,Chepauk-Thiruvallikeni,SRINIVASAN,IND,138,1,139,137405,234327,69355
19,Chepauk-Thiruvallikeni,CHANDRANATHAN S,IND,118,0,118,137405,234327,69355
19,Chepauk-Thiruvallikeni,MOHAMED RIOZ,Anaithu Makkal Arasiyal Katchi,112,0,112,137405,234327,69355
19,Chepauk-Thiruvallikeni,NAGARAJAN,IND,109,1,110,137405,234327,69355
19,Chepauk-Thiruvallikeni,ABID BAKSHQ H HUSSAIN,Republican Party of India (Athawale),104,1,105,137405,234327,69355
19,Chepauk-Thiruvallikeni,RAVI M L,Desiya Makkal Sakthi Katchi,89,0,89,137405,234327,69355
19,Chepauk-Thiruvallikeni,ANANDAN  K,IND,87,1,88,137405,234327,69355
19,Chepauk-Thiruvallikeni,MUNIYANDI,IND,81,0,81,137405,234327,69355
19,Chepauk-Thiruvallikeni,KANNAN C,IND,63,2,65,137405,234327,69355
19,Chepauk-Thiruvallikeni,KRISHNADASAN S,IND,57,0,57,137405,234327,69355
19,Chepauk-Thiruvallikeni,BALAJI C,IND,53,0,53,137405,234327,69355
19,Chepauk-Thiruvallikeni,MANIKANDAN E,IND,49,1,50,137405,234327,69355
19,Chepauk-Thiruvallikeni,DILLIRAJ P,IND,49,0,49,137405,234327,69355
19,Chepauk-Thiruvallikeni,MADHANA GOPAL T,IND,42,0,42,137405,234327,69355
19,Chepauk-Thiruvallikeni,Ganesan P,IND,39,0,39,137405,234327,69355
19,Chepauk-Thiruvallikeni,BALAJI K,IND,34,1,35,137405,234327,69355
19,Chepauk-Thiruvallikeni,MOHAMMED HUSSAIN,IND,33,1,34,137405,234327,69355
20,Thousand Lights,EZHILAN N,DMK,71437,430,71867,135940,242602,32462
20,Thousand Lights,KUSHBOO SUNDAR,BJP,39237,168,39405,135940,242602,32462
20,Thousand Lights,K M SHARIFF,MNM,11769,22,11791,135940,242602,32462
20,Thousand Lights,SHERINE AJ,NTK,8860,24,8884,135940,242602,32462
20,Thousand Lights,NOTA,NOTA,1381,4,1385,135940,242602,32462
20,Thousand Lights,VAIDHYANATHAN N,AMMK,1145,10,1155,135940,242602,32462
20,Thousand Lights,WILLIAMS D,BSP,245,1,246,135940,242602,32462
20,Thousand Lights,RADHA KRISHNAN S,IND,230,1,231,135940,242602,32462
20,Thousand Lights,MANIVANNAN N,IND,229,0,229,135940,242602,32462
20,Thousand Lights,PARTHIBAN V,IND,154,0,154,135940,242602,32462
20,Thousand Lights,DOMNIC A,Nam India Naam Indiyar Katchi,72,0,72,135940,242602,32462
20,Thousand Lights,SANJEEVI S,IND,66,0,66,135940,242602,32462
20,Thousand Lights,SUDAKAR R,IND,63,3,66,135940,242602,32462
20,Thousand Lights,BABU A,IND,65,0,65,135940,242602,32462
20,Thousand Lights,A GEORGE BENNY,IND,62,0,62,135940,242602,32462
20,Thousand Lights,NIRMAL KUMAR S,IND,53,0,53,135940,242602,32462
20,Thousand Lights,RIAZ(A) SYED ZAKEERULLA,Anaithu Makkal Arasiyal Katchi,52,0,52,135940,242602,32462
20,Thousand Lights,P PARIMALA,IND,47,0,47,135940,242602,32462
20,Thousand Lights,VELRAJ S,IND,41,1,42,135940,242602,32462
20,Thousand Lights,DEEBAN M,IND,37,0,37,135940,242602,32462
20,Thousand Lights,SEKAR K,IND,30,1,31,135940,242602,32462
21,Anna Nagar,M.K. Mohan,DMK,79356,698,80054,165096,286179,27445
21,Anna Nagar,S. Gokula Indira,AIADMK,52297,312,52609,165096,286179,27445
21,Anna Nagar,V. Ponraj,MNM,17434,88,17522,165096,286179,27445
21,Anna Nagar,S. Shankar,NTK,10361,45,10406,165096,286179,27445
21,Anna Nagar,NOTA,NOTA,1529,16,1545,165096,286179,27445
21,Anna Nagar,K.N. Gunasekaran,AMMK,1163,6,1169,165096,286179,27445
21,Anna Nagar,S.D. Prabhakar,Tamil Nadu Ilangyar Katchi,406,2,408,165096,286179,27445
21,Anna Nagar,D. JeevithKumar,BSP,220,0,220,165096,286179,27445
21,Anna Nagar,S. Sathyanarayanan,IND,158,0,158,165096,286179,27445
21,Anna Nagar,Hari Shankar,IND,141,1,142,165096,286179,27445
21,Anna Nagar,K. Sathish Kumar,IND,125,0,125,165096,286179,27445
21,Anna Nagar,R. Saravanan,IND,122,0,122,165096,286179,27445
21,Anna Nagar,V.M. Nagarajan,IND,84,2,86,165096,286179,27445
21,Anna Nagar,L. Kasinathan,IND,74,0,74,165096,286179,27445
21,Anna Nagar,V. Paulraj Guna,Republican Party of India (Athawale),73,0,73,165096,286179,27445
21,Anna Nagar,Ansar Ahamed,Anaithu Makkal Arasiyal Katchi,69,0,69,165096,286179,27445
21,Anna Nagar,P.E. Gopinath,IND,62,0,62,165096,286179,27445
21,Anna Nagar,P. Dhanasekar,Nam India Naam Indiyar Katchi,59,0,59,165096,286179,27445
21,Anna Nagar,S. Yuvaraja,Veerath Thiyagi Viswanathadoss Thozhilalarkal Katchi,56,0,56,165096,286179,27445
21,Anna Nagar,J. Nagaraj,New Generation People’s Party,53,0,53,165096,286179,27445
21,Anna Nagar,M. Veriyandi,Anna MGR Dravida Makkal Kalgam,32,0,32,165096,286179,27445
21,Anna Nagar,M. Manokaran,IND,27,0,27,165096,286179,27445
21,Anna Nagar,P. Manimaran,IND,13,0,13,165096,286179,27445
21,Anna Nagar,A. Jayaprakash,IND,12,0,12,165096,286179,27445
22,Virugampakkam,AMV.PRABHAKARA RAJA,DMK,73814,537,74351,169087,291224,18367
22,Virugampakkam,VIRUGAI V.N.RAVI,AIADMK,55526,458,55984,169087,291224,18367
22,Virugampakkam,SENEGAN,MNM,16871,68,16939,169087,291224,18367
22,Virugampakkam,T.S.RAJENDRAN,NTK,10153,32,10185,169087,291224,18367
22,Virugampakkam,M.GUNASEKARAN (A) STAR M.GUNASEKARAN,IND,5165,21,5186,169087,291224,18367
22,Virugampakkam,B.PARTHASARATHY,DMDK,1584,1,1585,169087,291224,18367
22,Virugampakkam,NOTA,NOTA,1551,12,1563,169087,291224,18367
22,Virugampakkam,R.MAYILSAMY,IND,1436,4,1440,169087,291224,18367
22,Virugampakkam,SATHASIVAM,IND,344,0,344,169087,291224,18367
22,Virugampakkam,M.S.ISMAIL KHAN,All India Jananayaka Makkal Kazhagam,206,3,209,169087,291224,18367
22,Virugampakkam,M.MANNU,IND,146,2,148,169087,291224,18367
22,Virugampakkam,V.GUNASEKARAN,IND,131,0,131,169087,291224,18367
22,Virugampakkam,M.SIVAKUMAR,IND,119,0,119,169087,291224,18367
22,Virugampakkam,G.THANIGACHALAM,Veerath Thiyagi Viswanathadoss Thozhilalarkal Katchi,90,0,90,169087,291224,18367
22,Virugampakkam,MANJU,Anaithu Makkal Arasiyal Katchi,89,1,90,169087,291224,18367
22,Virugampakkam,S.GUNASEKAR,IND,86,2,88,169087,291224,18367
22,Virugampakkam,G.RAVI,Rashtriya Janata Dal,69,4,73,169087,291224,18367
22,Virugampakkam,M.ELLANGOVAN,IND,68,4,72,169087,291224,18367
22,Virugampakkam,E.SANKAR,IND,68,0,68,169087,291224,18367
22,Virugampakkam,R.PRABAHARAN,Tamizhaga Murpokku Makkal Katchi,63,2,65,169087,291224,18367
22,Virugampakkam,D.SUNDAR SINGH,IND,56,0,56,169087,291224,18367
22,Virugampakkam,D.PRABAKARAN,IND,55,1,56,169087,291224,18367
22,Virugampakkam,M.SRINIVASAN,IND,49,0,49,169087,291224,18367
22,Virugampakkam,V.THALAPATHI,IND,49,0,49,169087,291224,18367
22,Virugampakkam,V.K.KATHIR,IND,48,0,48,169087,291224,18367
22,Virugampakkam,S.R.DINESH KUMAR,Anna MGR Dravida Makkal Kalgam,40,1,41,169087,291224,18367
22,Virugampakkam,K.BOOPATHY,IND,34,0,34,169087,291224,18367
22,Virugampakkam,V.K.SENTHIL KUMAR,IND,24,0,24,169087,291224,18367
23,Saidapet,SUBRAMANIAN. MA,DMK,79715,479,80194,160327,279609,29408
23,Saidapet,SAIDAI DURAISAMY,AIADMK,50633,153,50786,160327,279609,29408
23,Saidapet,SNEGAPRIYA,MNM,13413,41,13454,160327,279609,29408
23,Saidapet,SURESH KUMAR. B,NTK,10687,30,10717,160327,279609,29408
23,Saidapet,SENTHAMIZHAN. G,AMMK,2076,5,2081,160327,279609,29408
23,Saidapet,NOTA,NOTA,1155,3,1158,160327,279609,29408
23,Saidapet,KOTTUR KUMAR. R,BSP,274,0,274,160327,279609,29408
23,Saidapet,SAGAYAMARY. N,Republican Party of India (Athawale),208,1,209,160327,279609,29408
23,Saidapet,SIVASANKAR. S. R,IND,182,0,182,160327,279609,29408
23,Saidapet,BALAJI. V,IND,145,0,145,160327,279609,29408
23,Saidapet,KANDHASAMY. R,IND,141,0,141,160327,279609,29408
23,Saidapet,MURTHI. R,IND,125,0,125,160327,279609,29408
23,Saidapet,SATHISH KUMAR. S,IND,121,0,121,160327,279609,29408
23,Saidapet,SARAVANAN. D,IND,91,0,91,160327,279609,29408
23,Saidapet,SIVAGNANASAMBANDAN. T,Desiya Makkal Sakthi Katchi,87,2,89,160327,279609,29408
23,Saidapet,JOTHI SAIRAM. S,IND,66,0,66,160327,279609,29408
23,Saidapet,KOTHANDAPANI. K,IND,48,0,48,160327,279609,29408
23,Saidapet,IMRAN KHAN. M,IND,47,0,47,160327,279609,29408
23,Saidapet,MANIMARAN. S,IND,43,0,43,160327,279609,29408
23,Saidapet,PREM KUMAR. A,IND,40,0,40,160327,279609,29408
23,Saidapet,ASHOK KUMAR. V,IND,38,0,38,160327,279609,29408
23,Saidapet,VIJAYA KUMAR. R,IND,37,0,37,160327,279609,29408
23,Saidapet,LOGANATHAN. J,IND,34,0,34,160327,279609,29408
23,Saidapet,VENKATESH. K,IND,32,0,32,160327,279609,29408
23,Saidapet,RISHI KUMAR. A,IND,31,0,31,160327,279609,29408
23,Saidapet,ARUN KUMAR. M,IND,30,0,30,160327,279609,29408
23,Saidapet,VASANTH. H,IND,30,0,30,160327,279609,29408
23,Saidapet,ELANGO. K,IND,22,1,23,160327,279609,29408
23,Saidapet,RAJESH. N,IND,23,0,23,160327,279609,29408
23,Saidapet,PRAKASH. C,IND,20,0,20,160327,279609,29408
23,Saidapet,ALAGANATHAN. B,IND,18,0,18,160327,279609,29408
24,Thiyagarayanagar,KARUNANITHI J,DMK,55465,570,56035,138114,244694,137
24,Thiyagarayanagar,SATHIYANAARAYANAN B,AIADMK,55006,892,55898,138114,244694,137
24,Thiyagarayanagar,KARUPPIAH PALA,MNM,14473,94,14567,138114,244694,137
24,Thiyagarayanagar,SIVASANKARI S,NTK,8259,25,8284,138114,244694,137
24,Thiyagarayanagar,NOTA,NOTA,1597,20,1617,138114,244694,137
24,Thiyagarayanagar,BHARANEESWARAN R,AMMK,774,8,782,138114,244694,137
24,Thiyagarayanagar,JOHNSON R,BSP,259,10,269,138114,244694,137
24,Thiyagarayanagar,PALAYAN R,IND,124,0,124,138114,244694,137
24,Thiyagarayanagar,DHANUSH M,United States of India Party,109,0,109,138114,244694,137
24,Thiyagarayanagar,RAJASEKARAN D,IND,92,0,92,138114,244694,137
24,Thiyagarayanagar,VETRI SELVI,Anaithu Makkal Arasiyal Katchi,79,9,88,138114,244694,137
24,Thiyagarayanagar,KANNAN S,IND,86,2,88,138114,244694,137
24,Thiyagarayanagar,DHANASEKARAN R,Desiya Makkal Sakthi Katchi,72,2,74,138114,244694,137
24,Thiyagarayanagar,ELLAPPAN A.K.D,Mahathma Makkal Munnetra Kazhakam,50,2,52,138114,244694,137
24,Thiyagarayanagar,THIRUNAVUKKARASU V,Makkalatchi Katchi,33,2,35,138114,244694,137
25,Mylapore,VELU.DHA,DMK,67919,473,68392,153430,269455,12633
25,Mylapore,NATARAJ.R,AIADMK,55466,293,55759,153430,269455,12633
25,Mylapore,SRIPRIYA,MNM,14850,54,14904,153430,269455,12633
25,Mylapore,MAHALAKSHMI.K,NTK,10098,26,10124,153430,269455,12633
25,Mylapore,NOTA,NOTA,1279,8,1287,153430,269455,12633
25,Mylapore,KARTHICK.D,AMMK,1113,5,1118,153430,269455,12633
25,Mylapore,BALAJI,BSP,410,3,413,153430,269455,12633
25,Mylapore,RADHA M (TRANSGENDER),IND,203,0,203,153430,269455,12633
25,Mylapore,NALLAPPAN.G,IND,181,0,181,153430,269455,12633
25,Mylapore,NATARAJAN P,IND,127,2,129,153430,269455,12633
25,Mylapore,PASUPATHI PRAGALATHAN,IND,117,0,117,153430,269455,12633
25,Mylapore,MOHANRAJ.J,Jebamani Janata,113,0,113,153430,269455,12633
25,Mylapore,SELVAKUMAR,IND,112,0,112,153430,269455,12633
25,Mylapore,RANGARAJAN.R,IND,93,0,93,153430,269455,12633
25,Mylapore,NANDAGOPAL.G,IND,85,2,87,153430,269455,12633
25,Mylapore,SENTHIL KUMAR.D,Anaithu Makkal Arasiyal Katchi,82,0,82,153430,269455,12633
25,Mylapore,ARUNRAJ BALAN,IND,76,0,76,153430,269455,12633
25,Mylapore,VARATHARAJAN.V.S,IND,49,1,50,153430,269455,12633
25,Mylapore,KAJENDRAN.M,IND,35,3,38,153430,269455,12633
25,Mylapore,V. VIJAYA KRISHNA,IND,38,0,38,153430,269455,12633
25,Mylapore,SHANMUGARAJAN B,IND,35,0,35,153430,269455,12633
25,Mylapore,MALAR KANNAN.R,IND,29,0,29,153430,269455,12633
25,Mylapore,KUPPUSWAMY.T.M,IND,26,0,26,153430,269455,12633
25,Mylapore,VENKATESH,IND,24,0,24,153430,269455,12633
26,Velachery,JMH.AASSAN MAULAANA,INC,67998,495,68493,176714,313871,4352
26,Velachery,M.K.ASHOK,AIADMK,63830,311,64141,176714,313871,4352
26,Velachery,Dr. SANTHOSH BABU IAS (Retd),MNM,22992,80,23072,176714,313871,4352
26,Velachery,M.KEERTHANA,NTK,14142,29,14171,176714,313871,4352
26,Velachery,M.CHANDRABOSE,AMMK,1972,5,1977,176714,313871,4352
26,Velachery,NOTA,NOTA,1725,17,1742,176714,313871,4352
26,Velachery,V.L.REVATHI JAYAKUMARI,Tamil Nadu Ilangyar Katchi,746,4,750,176714,313871,4352
26,Velachery,C.VELU,BSP,473,4,477,176714,313871,4352
26,Velachery,V.SIVARAMAN,IND,282,0,282,176714,313871,4352
26,Velachery,GEETHA,New Generation People’s Party,277,1,278,176714,313871,4352
26,Velachery,A.TAMIL AZHAGAN,IND,229,0,229,176714,313871,4352
26,Velachery,V.HARIHARAN,IND,170,0,170,176714,313871,4352
26,Velachery,N.MAHALAKSHMI,IND,143,0,143,176714,313871,4352
26,Velachery,S.JOTHI KANNAN,IND,116,1,117,176714,313871,4352
26,Velachery,MURALI BALAJI,IND,116,0,116,176714,313871,4352
26,Velachery,S.GOKUL,IND,89,0,89,176714,313871,4352
26,Velachery,R.KANCHANA,Tamizhaga Murpokku Makkal Katchi,86,1,87,176714,313871,4352
26,Velachery,A.CHANDRAN,MGR Makkal Katchi,85,0,85,176714,313871,4352
26,Velachery,J.VICTOR PAUL,Republican Party of India (Athawale),69,0,69,176714,313871,4352
26,Velachery,D.VENKATESHAN,Anaithu Makkal Arasiyal Katchi,63,0,63,176714,313871,4352
26,Velachery,K.KANNAN,IND,57,0,57,176714,313871,4352
26,Velachery,G.YESUDASAN,IND,48,0,48,176714,313871,4352
26,Velachery,M.VIGNESH,IND,34,0,34,176714,313871,4352
26,Velachery,A.VETRISELVAN,IND,24,0,24,176714,313871,4352
27,Shozhinganallur,S.ARAVINDRAMESH,DMK,170675,883,171558,388355,694888,35405
27,Shozhinganallur,K.P.KANDAN,AIADMK,135834,319,136153,388355,694888,35405
27,Shozhinganallur,S.MICHAEL,NTK,38825,47,38872,388355,694888,35405
27,Shozhinganallur,RAJIV KUMAR,MNM,30229,55,30284,388355,694888,35405
27,Shozhinganallur,R.MURUGAN,DMDK,3903,9,3912,388355,694888,35405
27,Shozhinganallur,NOTA,NOTA,3021,9,3030,388355,694888,35405
27,Shozhinganallur,K.SURJITHKUMAR,IND,674,2,676,388355,694888,35405
27,Shozhinganallur,G.PRAKASH ROBERT,BSP,551,3,554,388355,694888,35405
27,Shozhinganallur,S.SENTHIL,IND,477,0,477,388355,694888,35405
27,Shozhinganallur,H.ARAVINDHKUMAR,IND,448,4,452,388355,694888,35405
27,Shozhinganallur,M.RAJESWARIPRIYA,Anaithu Makkal Arasiyal Katchi,426,1,427,388355,694888,35405
27,Shozhinganallur,K.SENTHILKUMAR,IND,310,0,310,388355,694888,35405
27,Shozhinganallur,R.SELVAVIGNESH,IND,176,0,176,388355,694888,35405
27,Shozhinganallur,A.I.AHAMED SHAH,IND,171,1,172,388355,694888,35405
27,Shozhinganallur,T.ELUMALAI,Anna MGR Dravida Munnetra Kazhagam,160,0,160,388355,694888,35405
27,Shozhinganallur,D.SRINIVASAN,IND,149,0,149,388355,694888,35405
27,Shozhinganallur,Dr. V.KANDAN,IND,146,1,147,388355,694888,35405
27,Shozhinganallur,G.VELAVAN,IND,134,0,134,388355,694888,35405
27,Shozhinganallur,E.RAJESH,IND,127,0,127,388355,694888,35405
27,Shozhinganallur,D.VENUGOPAL,IND,117,0,117,388355,694888,35405
27,Shozhinganallur,D.KALANITHI,IND,96,0,96,388355,694888,35405
27,Shozhinganallur,R.RAVICHANDRAN,IND,95,0,95,388355,694888,35405
27,Shozhinganallur,P.ARULRAJ,IND,67,5,72,388355,694888,35405
27,Shozhinganallur,K.NARASIMMAN,IND,58,0,58,388355,694888,35405
27,Shozhinganallur,A.DHANASEKAR,IND,57,0,57,388355,694888,35405
27,Shozhinganallur,S.PRITHIVIRAJ,IND,45,0,45,388355,694888,35405
27,Shozhinganallur,A.MOHAMMED GANI,IND,45,0,45,388355,694888,35405
28,Alandur,T.M.Anbarasan,DMK,115777,1008,116785,237751,389875,40571
28,Alandur,B.Valarmathi,AIADMK,75634,580,76214,237751,389875,40571
28,Alandur,Sarathbabu,MNM,21045,72,21117,237751,389875,40571
28,Alandur,Dr.R.Karthikeyan,NTK,16453,53,16506,237751,389875,40571
28,Alandur,NOTA,NOTA,1878,10,1888,237751,389875,40571
28,Alandur,M Mohammed Thameem Ansari,SOCIAL DEMOCRATIC PARTY OF INDIA,1750,11,1761,237751,389875,40571
28,Alandur,G Kamalakannan,Tamil Nadu Ilangyar Katchi,1096,9,1105,237751,389875,40571
28,Alandur,N.Raja,Desiya Makkal Sakthi Katchi,261,4,265,237751,389875,40571
28,Alandur,A.Abrahamlincon,IND,260,0,260,237751,389875,40571
28,Alandur,M.Valarmathi,IND,229,10,239,237751,389875,40571
28,Alandur,Ali Mohamed,IND,219,1,220,237751,389875,40571
28,Alandur,E.Anbarasu,IND,199,3,202,237751,389875,40571
28,Alandur,Subashree,Anaithu Makkal Arasiyal Katchi,187,0,187,237751,389875,40571
28,Alandur,S.Sridhar,IND,156,0,156,237751,389875,40571
28,Alandur,P.Sathiyaraj,IND,140,0,140,237751,389875,40571
28,Alandur,M Anbarasu,IND,108,0,108,237751,389875,40571
28,Alandur,Nithyanandham S,IND,106,1,107,237751,389875,40571
28,Alandur,S.Anbarasu,IND,84,0,84,237751,389875,40571
28,Alandur,M.Ashok Kumar,IND,73,1,74,237751,389875,40571
28,Alandur,Dr.R.Suresh,Bhartiya Manavadhikaar Federal Party,63,0,63,237751,389875,40571
28,Alandur,Rajesh Chinnadurai,National Democratic Party of South India,54,6,60,237751,389875,40571
28,Alandur,S.V.Saravanan,IND,56,0,56,237751,389875,40571
28,Alandur,J.Vincent,Republican Party of India (Athawale),36,10,46,237751,389875,40571
28,Alandur,K Saravanan,IND,40,0,40,237751,389875,40571
28,Alandur,C Saravanan,IND,39,1,40,237751,389875,40571
28,Alandur,B Raji,IND,28,0,28,237751,389875,40571
29,Sriperumbudur,SELVAPERUNTHAGAI,INC,114554,799,115353,264262,357436,10879
29,Sriperumbudur,PALANI,AIADMK,104017,457,104474,264262,357436,10879
29,Sriperumbudur,PUSHPARAJ,NTK,21998,36,22034,264262,357436,10879
29,Sriperumbudur,THANIGAIVEL,MNM,8838,32,8870,264262,357436,10879
29,Sriperumbudur,VAIRAMUTHU,IND,6325,15,6340,264262,357436,10879
29,Sriperumbudur,PERUMAL,AMMK,3125,19,3144,264262,357436,10879
29,Sriperumbudur,NOTA,NOTA,2132,7,2139,264262,357436,10879
29,Sriperumbudur,VINOTH,BSP,802,1,803,264262,357436,10879
29,Sriperumbudur,SAROJA,IND,280,2,282,264262,357436,10879
29,Sriperumbudur,LEENA,IND,138,0,138,264262,357436,10879
29,Sriperumbudur,VEDHAGIRI,IND,132,3,135,264262,357436,10879
29,Sriperumbudur,DEVARAJAN,IND,114,15,129,264262,357436,10879
29,Sriperumbudur,VASANTHI,IND,123,1,124,264262,357436,10879
29,Sriperumbudur,LOKESH,Desiya Makkal Sakthi Katchi,123,0,123,264262,357436,10879
29,Sriperumbudur,SUDHAKAR,IND,88,12,100,264262,357436,10879
29,Sriperumbudur,PARTHIBAN,IND,74,0,74,264262,357436,10879
30,Pallavaram,KARUNANITHI,DMK,125705,722,126427,266194,435186,37781
30,Pallavaram,RAJENDRAN,AIADMK,88312,334,88646,266194,435186,37781
30,Pallavaram,MINISHREE KANAGARAJ,NTK,21322,40,21362,266194,435186,37781
30,Pallavaram,SENTHIL KUMAR,MNM,20567,45,20612,266194,435186,37781
30,Pallavaram,MURUGESAN,DMDK,3713,5,3718,266194,435186,37781
30,Pallavaram,NOTA,NOTA,1935,10,1945,266194,435186,37781
30,Pallavaram,SERMA SELVARAJ,Desiya Makkal Sakthi Katchi,525,0,525,266194,435186,37781
30,Pallavaram,KARTHICK,BSP,519,0,519,266194,435186,37781
30,Pallavaram,GOKULKRISHNAN,Tamil Nadu Ilangyar Katchi,430,2,432,266194,435186,37781
30,Pallavaram,KUMARA DOSS,IND,274,0,274,266194,435186,37781
30,Pallavaram,SADAM HUSSAIN,IND,266,1,267,266194,435186,37781
30,Pallavaram,SATHYASEELAN,Lok Jan Shakti Party,232,2,234,266194,435186,37781
30,Pallavaram,AJITHKUMAR,PT,200,2,202,266194,435186,37781
30,Pallavaram,VEERALAKSHMI,My India Party,171,0,171,266194,435186,37781
30,Pallavaram,BALAJI,IND,166,1,167,266194,435186,37781
30,Pallavaram,KANAGARAJ,IND,133,0,133,266194,435186,37781
30,Pallavaram,MICHAEL,IND,124,0,124,266194,435186,37781
30,Pallavaram,RAMACHANDRAN.R,IND,96,0,96,266194,435186,37781
30,Pallavaram,PERUMAL,IND,86,0,86,266194,435186,37781
30,Pallavaram,SASIKUMAR LAKSHMIPATHY,National Democratic Party of South India,84,1,85,266194,435186,37781
30,Pallavaram,SRIDHARAN,Dravida Murpokku Makkal Katchi,69,0,69,266194,435186,37781
30,Pallavaram,KUMAR,Anna MGR Dravida Makkal Kalgam,58,1,59,266194,435186,37781
30,Pallavaram,BHASKARAN,IND,40,1,41,266194,435186,37781
31,Tambaram,Raja.S.R,DMK,115721,1119,116840,248968,413581,36824
31,Tambaram,Chinnaiyah.T.K.M,AIADMK,79509,507,80016,248968,413581,36824
31,Tambaram,Elango.Siva,MNM,22466,64,22530,248968,413581,36824
31,Tambaram,Sureshkumar.T,NTK,19463,31,19494,248968,413581,36824
31,Tambaram,Karikalan.M,AMMK,4194,13,4207,248968,413581,36824
31,Tambaram,NOTA,NOTA,2276,8,2284,248968,413581,36824
31,Tambaram,Abdulnazar P A,Tamil Nadu Ilangyar Katchi,1348,3,1351,248968,413581,36824
31,Tambaram,Harikrishnan.R,BSP,314,3,317,248968,413581,36824
31,Tambaram,Laksmanan N.,IND,264,0,264,248968,413581,36824
31,Tambaram,Sigamani S,IND,247,0,247,248968,413581,36824
31,Tambaram,KRISHNA T V N H S R.,IND,212,3,215,248968,413581,36824
31,Tambaram,KAMATCHI U.,Anaithu Makkal Arasiyal Katchi,199,0,199,248968,413581,36824
31,Tambaram,Sivaraman.S,IND,168,1,169,248968,413581,36824
31,Tambaram,Rathinakumar R.,IND,149,2,151,248968,413581,36824
31,Tambaram,Anand Prabhu B.,IND,122,0,122,248968,413581,36824
31,Tambaram,Kannairam.B,IND,116,1,117,248968,413581,36824
31,Tambaram,Manojkumar A.,Shiv Sena,85,3,88,248968,413581,36824
31,Tambaram,Venkatesan.C,Veerath Thiyagi Viswanathadoss Thozhilalarkal Katchi,73,0,73,248968,413581,36824
31,Tambaram,Venkatesan Balaji B.,IND,71,0,71,248968,413581,36824
31,Tambaram,Justin Charles.P,Republican Party of India (Athawale),64,0,64,248968,413581,36824
31,Tambaram,Ramu A,National Democratic Party of South India,53,3,56,248968,413581,36824
31,Tambaram,Thangaraj V.,IND,46,1,47,248968,413581,36824
31,Tambaram,Balakrishnan G.,IND,46,0,46,248968,413581,36824
32,Chengalpattu,VARALAKSHMI.M,DMK,129317,1256,130573,274087,425273,26665
32,Chengalpattu,GAJENDRAN.M,AIADMK,103561,347,103908,274087,425273,26665
32,Chengalpattu,SANJEEVINATHAN.K,NTK,26813,55,26868,274087,425273,26665
32,Chengalpattu,MUTHAMILSELVAN.S,Indiya Jananayaka Katchi,4133,13,4146,274087,425273,26665
32,Chengalpattu,NOTA,NOTA,3058,17,3075,274087,425273,26665
32,Chengalpattu,SATHISHKUMAR.A,AMMK,3063,6,3069,274087,425273,26665
32,Chengalpattu,ERANIAPPAN.S,CPI(ML)(L),684,0,684,274087,425273,26665
32,Chengalpattu,DILLIBABU.S,Tipu Sultan Party,403,1,404,274087,425273,26665
32,Chengalpattu,VEERADOSS.E,IND,343,1,344,274087,425273,26665
32,Chengalpattu,SEETHALAKSHMI.I,IND,314,3,317,274087,425273,26665
32,Chengalpattu,RAJAGOPAL.G,IND,233,0,233,274087,425273,26665
32,Chengalpattu,SARAVANAN.D,All India Jananayaka Makkal Kazhagam,195,0,195,274087,425273,26665
32,Chengalpattu,VASUMATHI.G,Anaithu Makkal Arasiyal Katchi,141,1,142,274087,425273,26665
32,Chengalpattu,GOPALAKRISHNAN.N,IND,129,0,129,274087,425273,26665
33,Thiruporur,S.S.Balaji,VCK,92987,967,93954,226729,293265,1947
33,Thiruporur,Arumugam.K,PMK,91388,619,92007,226729,293265,1947
33,Thiruporur,Mohana Sundari.S,NTK,20354,74,20428,226729,293265,1947
33,Thiruporur,Lavanya.N,MNM,8125,69,8194,226729,293265,1947
33,Thiruporur,Kothandapani.M,AMMK,7629,33,7662,226729,293265,1947
33,Thiruporur,NOTA,NOTA,1971,11,1982,226729,293265,1947
33,Thiruporur,V.K.Pakkiri Ambadkar,BSP,1129,6,1135,226729,293265,1947
33,Thiruporur,A.Joshva,IND,367,0,367,226729,293265,1947
33,Thiruporur,S.Nataraj,IND,268,3,271,226729,293265,1947
33,Thiruporur,U.Akbar Bhasha,IND,267,1,268,226729,293265,1947
33,Thiruporur,D.Ravi,IND,266,2,268,226729,293265,1947
33,Thiruporur,M.Duraisamy,IND,190,3,193,226729,293265,1947
34,Cheyyur,Babu M,VCK,81533,1217,82750,179120,226687,4042
34,Cheyyur,Kanitha S,AIADMK,78144,564,78708,179120,226687,4042
34,Cheyyur,Rajesh R,NTK,9568,85,9653,179120,226687,4042
34,Cheyyur,Siva A,DMDK,3026,28,3054,179120,226687,4042
34,Cheyyur,Anbu Tamilsekaran P,MNM,1927,41,1968,179120,226687,4042
34,Cheyyur,NOTA,NOTA,1127,14,1141,179120,226687,4042
34,Cheyyur,Ilayaraja S,BSP,960,4,964,179120,226687,4042
34,Cheyyur,Vinoth M,IND,402,1,403,179120,226687,4042
34,Cheyyur,Babu E,IND,247,16,263,179120,226687,4042
34,Cheyyur,Amarnath B,IND,215,1,216,179120,226687,4042
35,Madurantakam,Maragatham. K,AIADMK,85791,855,86646,185842,226346,-3570
35,Madurantakam,Sathya. C.E,DMK,81739,1337,83076,185842,226346,-3570
35,Madurantakam,Sumitha. P,NTK,9249,44,9293,185842,226346,-3570
35,Madurantakam,Moorthi . N,DMDK,2130,7,2137,185842,226346,-3570
35,Madurantakam,Dinesh. K,MNM,1476,12,1488,185842,226346,-3570
35,Madurantakam,NOTA,NOTA,1369,2,1371,185842,226346,-3570
35,Madurantakam,Tamizhselvan. S,IND,633,6,639,185842,226346,-3570
35,Madurantakam,Madhanraj. M,BSP,587,0,587,185842,226346,-3570
35,Madurantakam,Kothandan. A,Desiya Sirupanmayinar Makkal Iyakkam,249,2,251,185842,226346,-3570
35,Madurantakam,Ranjitham. M,IND,233,0,233,185842,226346,-3570
35,Madurantakam,Subash. S,Makkal Munnetra Peravai,120,1,121,185842,226346,-3570
36,Uthiramerur,SUNDAR K,DMK,92161,1266,93427,210529,259635,1622
36,Uthiramerur,SOMASUNDARAM V,AIADMK,91127,678,91805,210529,259635,1622
36,Uthiramerur,KAMACTHI.S,NTK,11320,85,11405,210529,259635,1622
36,Uthiramerur,RANJITHKUMAR.R.V,AMMK,7181,30,7211,210529,259635,1622
36,Uthiramerur,SUSAIAPPAR.A,MNM,2077,23,2100,210529,259635,1622
36,Uthiramerur,NOTA,NOTA,946,6,952,210529,259635,1622
36,Uthiramerur,PONNAMBALAM.R,IND,752,1,753,210529,259635,1622
36,Uthiramerur,SURESH D,BSP,600,2,602,210529,259635,1622
36,Uthiramerur,MADHAVARAJ.K.V,IND,448,0,448,210529,259635,1622
36,Uthiramerur,THANGARAJ.K,IND,332,1,333,210529,259635,1622
36,Uthiramerur,JAYABALAN.E,IND,305,1,306,210529,259635,1622
36,Uthiramerur,SARAVANAN.A,IND,298,6,304,210529,259635,1622
36,Uthiramerur,DEVARAJAN.C,IND,140,1,141,210529,259635,1622
36,Uthiramerur,SIVAKUMAR.A,Desiya Makkal Sakthi Katchi,134,2,136,210529,259635,1622
36,Uthiramerur,AROKIASAMY.J,IND,91,13,104,210529,259635,1622
36,Uthiramerur,GUNASEKAR.V,IND,104,0,104,210529,259635,1622
36,Uthiramerur,CHINNASWAMY.T,IND,100,1,101,210529,259635,1622
36,Uthiramerur,JAISUDHA.V,Republican Party of India (Athawale),82,3,85,210529,259635,1622
36,Uthiramerur,JAYARAMAN.C.A,IND,81,1,82,210529,259635,1622
36,Uthiramerur,JEEVANANTHAM.D,IND,66,0,66,210529,259635,1622
36,Uthiramerur,SIVALINGAM.M,IND,64,0,64,210529,259635,1622
37,Kancheepuram,C.V.M.P. Ezhailzrasan,DMK,100914,1798,102712,229432,308426,11595
37,Kancheepuram,P. Magesh Kumar,PMK,90390,727,91117,229432,308426,11595
37,Kancheepuram,S. SALDIN,NTK,13829,117,13946,229432,308426,11595
37,Kancheepuram,B. GOPINATH,MNM,11936,92,12028,229432,308426,11595
37,Kancheepuram,NOTA,NOTA,2521,18,2539,229432,308426,11595
37,Kancheepuram,N. MANOGARAN,AMMK,2283,18,2301,229432,308426,11595
37,Kancheepuram,L. ARULNATHAN,IND,2024,26,2050,229432,308426,11595
37,Kancheepuram,K. Prabakaran,BSP,1185,8,1193,229432,308426,11595
37,Kancheepuram,D.GNANAMOORTHY,IND,412,3,415,229432,308426,11595
37,Kancheepuram,M. MEGANATHAN,New Generation People’s Party,241,7,248,229432,308426,11595
37,Kancheepuram,J. JAYARAJ,IND,192,1,193,229432,308426,11595
37,Kancheepuram,S. SRINIVASAN,IND,162,0,162,229432,308426,11595
37,Kancheepuram,T. MAGESH,IND,143,14,157,229432,308426,11595
37,Kancheepuram,R. VINOTHRAJ,IND,133,0,133,229432,308426,11595
37,Kancheepuram,P. EZHILARASAN,IND,126,1,127,229432,308426,11595
37,Kancheepuram,M.ELANGOVAN,IND,94,17,111,229432,308426,11595
38,Arakkonam,S.RAVI,AIADMK,85057,342,85399,171412,226516,-27169
38,Arakkonam,GOWTHAMA SANNAH.J,VCK,57345,885,58230,171412,226516,-27169
38,Arakkonam,E.ABIRAMI,NTK,14561,70,14631,171412,226516,-27169
38,Arakkonam,K.C.MANIVANNAN,AMMK,4747,30,4777,171412,226516,-27169
38,Arakkonam,S.BASKARAN,MNM,3522,21,3543,171412,226516,-27169
38,Arakkonam,P.SUDHAKAR,BSP,1816,9,1825,171412,226516,-27169
38,Arakkonam,NOTA,NOTA,1648,8,1656,171412,226516,-27169
38,Arakkonam,P.RAVI,IND,432,0,432,171412,226516,-27169
38,Arakkonam,C.M.GOWTHAMAN,IND,284,1,285,171412,226516,-27169
38,Arakkonam,M.MADHANRAJ,IND,184,0,184,171412,226516,-27169
38,Arakkonam,C.MOHAN,IND,128,0,128,171412,226516,-27169
38,Arakkonam,M.MANIKANDAN,IND,111,2,113,171412,226516,-27169
38,Arakkonam,A.GAUTHAMAN,IND,109,3,112,171412,226516,-27169
38,Arakkonam,V.RAVI,IND,96,1,97,171412,226516,-27169
39,Sholingur,A.M.MUNIRATHINAM,INC,109138,1090,110228,224109,275533,26698
39,Sholingur,A.M.KRISHNAN,PMK,82919,611,83530,224109,275533,26698
39,Sholingur,N.G.PARTHIBAN,AMMK,12877,102,12979,224109,275533,26698
39,Sholingur,Y.R.PAVENDHAN,NTK,9580,76,9656,224109,275533,26698
39,Sholingur,R.JAWAHAR,MNM,1649,15,1664,224109,275533,26698
39,Sholingur,NOTA,NOTA,1234,5,1239,224109,275533,26698
39,Sholingur,T.RAJENDRAN,IND,1014,1,1015,224109,275533,26698
39,Sholingur,M.GIRIDHARAN,BSP,611,3,614,224109,275533,26698
39,Sholingur,M.MUNIRATHINAM,IND,585,2,587,224109,275533,26698
39,Sholingur,J.BALAJI,IND,464,3,467,224109,275533,26698
39,Sholingur,A.PALANI,IND,466,0,466,224109,275533,26698
39,Sholingur,K.MANI,IND,369,3,372,224109,275533,26698
39,Sholingur,N.MANI,IND,326,0,326,224109,275533,26698
39,Sholingur,G.VIJAYAKUMAR,Desiya Sirupanmayinar Makkal Iyakkam,222,0,222,224109,275533,26698
39,Sholingur,P.PARTHIBAN,IND,204,1,205,224109,275533,26698
39,Sholingur,C.MUNIRATHINAM,IND,174,0,174,224109,275533,26698
39,Sholingur,R.VINOTH,Veerath Thiyagi Viswanathadoss Thozhilalarkal Katchi,131,1,132,224109,275533,26698
39,Sholingur,K.SEKAR,IND,121,0,121,224109,275533,26698
39,Sholingur,R.ELUMALAI,IND,111,1,112,224109,275533,26698
40,Katpadi,DURAIMURUGAN,DMK,83243,1897,85140,186246,247433,746
40,Katpadi,V RAMU,AIADMK,83675,719,84394,186246,247433,746
40,Katpadi,S THIRUKKUMARAN,NTK,10325,124,10449,186246,247433,746
40,Katpadi,NOTA,NOTA,1852,37,1889,186246,247433,746
40,Katpadi,A S RAJA,AMMK,1059,7,1066,186246,247433,746
40,Katpadi,M SUDHARSAN,Indiya Jananayaka Katchi,991,12,1003,186246,247433,746
40,Katpadi,V VINAYAGAM,IND,548,3,551,186246,247433,746
40,Katpadi,K RAJA,BSP,368,6,374,186246,247433,746
40,Katpadi,D RAMU,IND,332,0,332,186246,247433,746
40,Katpadi,R BASKARAN,IND,221,3,224,186246,247433,746
40,Katpadi,J ANANDHI,IND,177,16,193,186246,247433,746
40,Katpadi,P DHANANJAYAN,IND,163,3,166,186246,247433,746
40,Katpadi,ARUMUGAM K P,Republican Party of India (Athawale),142,2,144,186246,247433,746
40,Katpadi,RAMAN,IND,144,0,144,186246,247433,746
40,Katpadi,K RAMU,IND,99,0,99,186246,247433,746
40,Katpadi,R S SRIDHAR,Anna MGR Dravida Makkal Kalgam,75,3,78,186246,247433,746
41,Ranipet,R.GANDHI,DMK,102273,1018,103291,207462,264548,16498
41,Ranipet,S.M.SUGUMAR,AIADMK,86339,454,86793,207462,264548,16498
41,Ranipet,V.SHYLAJA,NTK,10152,82,10234,207462,264548,16498
41,Ranipet,M.ATHAM BASHA,MNM,2746,16,2762,207462,264548,16498
41,Ranipet,NOTA,NOTA,1625,7,1632,207462,264548,16498
41,Ranipet,A.YUVARAJ,BSP,664,5,669,207462,264548,16498
41,Ranipet,G.VEERAMANI,AMMK,627,10,637,207462,264548,16498
41,Ranipet,S.JAYAKUMAR,IND,425,0,425,207462,264548,16498
41,Ranipet,Dr.K.SATHIYARAJ,Tamil Nadu Ilangyar Katchi,273,2,275,207462,264548,16498
41,Ranipet,A.MANIKANDAN,IND,267,1,268,207462,264548,16498
41,Ranipet,A.MANSUR BASHA,IND,194,0,194,207462,264548,16498
41,Ranipet,S.YUVARAJ,IND,106,1,107,207462,264548,16498
41,Ranipet,S.GANDHI,IND,63,1,64,207462,264548,16498
41,Ranipet,N.SUGUMAR,IND,63,0,63,207462,264548,16498
41,Ranipet,K.SAKTHIVEL NATHAN,IND,48,0,48,207462,264548,16498
42,Arcot,J.L.Eswarappan,DMK,102667,1218,103885,209791,260136,19958
42,Arcot,Elavazagan.K.L,PMK,83410,517,83927,209791,260136,19958
42,Arcot,R.Kathiravan,NTK,11977,111,12088,209791,260136,19958
42,Arcot,A.R.Mohamed Raffi,MNM,2846,14,2860,209791,260136,19958
42,Arcot,NOTA,NOTA,2238,15,2253,209791,260136,19958
42,Arcot,N.Janarthanan,AMMK,2159,31,2190,209791,260136,19958
42,Arcot,A.C.Kesavan,BSP,771,11,782,209791,260136,19958
42,Arcot,K.Manigandan,IND,453,4,457,209791,260136,19958
42,Arcot,H.Mohamed Ghouse,Tipu Sultan Party,392,5,397,209791,260136,19958
42,Arcot,Vasanthakumar,IND,380,2,382,209791,260136,19958
42,Arcot,T.D.Shanmugam,IND,231,0,231,209791,260136,19958
42,Arcot,Munivel.S,National Democratic Party of South India,180,4,184,209791,260136,19958
42,Arcot,P.Eswaran,IND,155,0,155,209791,260136,19958
43,Vellore,Karthikeyan .P,DMK,82907,1392,84299,179899,251396,9181
43,Vellore,Appu S.R.K,AIADMK,74457,661,75118,179899,251396,9181
43,Vellore,Poonkundran .N,NTK,8454,76,8530,179899,251396,9181
43,Vellore,Vikram Chakravarthy .G,MNM,7179,64,7243,179899,251396,9181
43,Vellore,NOTA,NOTA,1417,24,1441,179899,251396,9181
43,Vellore,Naresh Kumar .R,Tamil Nadu Ilangyar Katchi,921,7,928,179899,251396,9181
43,Vellore,Dharmalingam .V.D,AMMK,860,5,865,179899,251396,9181
43,Vellore,Vishnumohan .E,IND,364,3,367,179899,251396,9181
43,Vellore,Vijayaraj .K,IND,224,0,224,179899,251396,9181
43,Vellore,Senthilkumar .P,Veerath Thiyagi Viswanathadoss Thozhilalarkal Katchi,200,2,202,179899,251396,9181
43,Vellore,Syed Jalaluddin .M,Tipu Sultan Party,186,1,187,179899,251396,9181
43,Vellore,Panneer Sevlan .N,IND,135,3,138,179899,251396,9181
43,Vellore,Naseer K,IND,90,1,91,179899,251396,9181
43,Vellore,Manogaran S,Kamarajar Deseeya Congress,67,0,67,179899,251396,9181
43,Vellore,Srinivasan .N,IND,67,0,67,179899,251396,9181
43,Vellore,Sathishkumar .S,IND,54,0,54,179899,251396,9181
43,Vellore,Karthikeyan .R,IND,40,2,42,179899,251396,9181
43,Vellore,Karthick .E,IND,35,1,36,179899,251396,9181
44,Anaikattu,A.P.Nandakumar,DMK,94084,1075,95159,197805,253388,6360
44,Anaikattu,D.Velazhagan,AIADMK,88031,768,88799,197805,253388,6360
44,Anaikattu,A.Sumithra,NTK,7974,151,8125,197805,253388,6360
44,Anaikattu,NOTA,NOTA,1768,23,1791,197805,253388,6360
44,Anaikattu,M.Senthil Kumar,IND,1335,22,1357,197805,253388,6360
44,Anaikattu,V.D.Sathish Kumar,AMMK,1125,15,1140,197805,253388,6360
44,Anaikattu,P Venkatesan,IND,468,0,468,197805,253388,6360
44,Anaikattu,K.Rajasekar,Indiya Jananayaka Katchi,323,5,328,197805,253388,6360
44,Anaikattu,M RajBabu,IND,179,0,179,197805,253388,6360
44,Anaikattu,T.Mathan Kumar,IND,149,1,150,197805,253388,6360
44,Anaikattu,N.Kirubakaran,IND,104,5,109,197805,253388,6360
44,Anaikattu,K.Naveenkumar,IND,93,1,94,197805,253388,6360
44,Anaikattu,R Karunamoorthy,IND,61,1,62,197805,253388,6360
44,Anaikattu,M.Arun,IND,42,2,44,197805,253388,6360
45,Kilvaithinankuppam,M.JAGAN MOORTHY,AIADMK,83989,590,84579,174124,223588,-10582
45,Kilvaithinankuppam,K Seetharaman,DMK,72933,1064,73997,174124,223588,-10582
45,Kilvaithinankuppam,J.Divya Rani,NTK,9911,116,10027,174124,223588,-10582
45,Kilvaithinankuppam,NOTA,NOTA,1773,25,1798,174124,223588,-10582
45,Kilvaithinankuppam,DHANASEELAN,DMDK,1406,26,1432,174124,223588,-10582
45,Kilvaithinankuppam,K ELAVARASAN,Republican Party of India (Athawale),543,4,547,174124,223588,-10582
45,Kilvaithinankuppam,PUSHPALATHA D,BSP,505,14,519,174124,223588,-10582
45,Kilvaithinankuppam,K VENKATASAMY,Indiya Jananayaka Katchi,519,0,519,174124,223588,-10582
45,Kilvaithinankuppam,S SELVA CHENGUTTUVAN,IND,324,7,331,174124,223588,-10582
45,Kilvaithinankuppam,E.P.ELANCHEZHIYAN,IND,238,4,242,174124,223588,-10582
45,Kilvaithinankuppam,K SATHU,National Democratic Party of South India,132,1,133,174124,223588,-10582
46,Gudiyattam,Amulu.V,DMK,99525,887,100412,211630,286255,6901
46,Gudiyattam,Paritha.G,AIADMK,93066,445,93511,211630,286255,6901
46,Gudiyattam,Kalaiyenthiri.R,NTK,11776,58,11834,211630,286255,6901
46,Gudiyattam,Jayanthi Padmanaban.C,AMMK,1793,17,1810,211630,286255,6901
46,Gudiyattam,NOTA,NOTA,1691,8,1699,211630,286255,6901
46,Gudiyattam,Raja.S,BSP,502,3,505,211630,286255,6901
46,Gudiyattam,Rajan.C,Indiya Jananayaka Katchi,477,5,482,211630,286255,6901
46,Gudiyattam,Jaikarthikeyan.K,IND,448,1,449,211630,286255,6901
46,Gudiyattam,Lakshmipathy.N,IND,255,2,257,211630,286255,6901
46,Gudiyattam,Elumalai.M,IND,166,2,168,211630,286255,6901
46,Gudiyattam,Gunaseelan.P,IND,137,0,137,211630,286255,6901
46,Gudiyattam,Selvavinayagam.D,All Pensioner’s Party,117,2,119,211630,286255,6901
46,Gudiyattam,Vennila.R,Republican Party of India (Athawale),65,2,67,211630,286255,6901
46,Gudiyattam,Radha,IND,66,0,66,211630,286255,6901
46,Gudiyattam,Priya.M,IND,60,2,62,211630,286255,6901
46,Gudiyattam,Manojkumar.G,IND,52,0,52,211630,286255,6901
47,Vaniyambadi,G.SENDHIL KUMAR,AIADMK,87340,678,88018,189997,247905,-4904
47,Vaniyambadi,N.MOHAMMED NAYEEM,IUML,82317,797,83114,189997,247905,-4904
47,Vaniyambadi,A.J.DEVENDHIRAN,NTK,11151,75,11226,189997,247905,-4904
47,Vaniyambadi,T.S.VAKEEL AHMED,All India Majlis-E-Ittehadul Muslimeen,1895,2,1897,189997,247905,-4904
47,Vaniyambadi,M.GNANA DOSS,MNM,1843,25,1868,189997,247905,-4904
47,Vaniyambadi,NOTA,NOTA,1487,5,1492,189997,247905,-4904
47,Vaniyambadi,D.Ramu,BSP,715,6,721,189997,247905,-4904
47,Vaniyambadi,M.SURESH,IND,362,0,362,189997,247905,-4904
47,Vaniyambadi,B.JAGAN,Akhil Bharat Hindu Mahasabha,351,5,356,189997,247905,-4904
47,Vaniyambadi,P.ABDUL WAHID,IND,258,1,259,189997,247905,-4904
47,Vaniyambadi,DELHI RAJI.S,IND,184,2,186,189997,247905,-4904
47,Vaniyambadi,C.M.MOHAMMED HUSSAIN,IND,186,0,186,189997,247905,-4904
47,Vaniyambadi,R.Sekar,All India Youth Development Party,176,3,179,189997,247905,-4904
47,Vaniyambadi,SYED MOHAMMED SALEEM,IND,131,2,133,189997,247905,-4904
48,Ambur,VILWANATHAN.A.C,DMK,89561,915,90476,177878,236824,20232
48,Ambur,NAZAR MOHAMED.K,AIADMK,69903,341,70244,177878,236824,20232
48,Ambur,MAHARUNNISHA,NTK,10102,48,10150,177878,236824,20232
48,Ambur,UMAR FAROOK.ASA,SOCIAL DEMOCRATIC PARTY OF INDIA,1787,6,1793,177878,236824,20232
48,Ambur,RAJA.S,MNM,1629,9,1638,177878,236824,20232
48,Ambur,NOTA,NOTA,1410,7,1417,177878,236824,20232
48,Ambur,WAZEER AHMED.J,BSP,678,3,681,177878,236824,20232
48,Ambur,MANI.S.P,All Pensioner’s Party,358,5,363,177878,236824,20232
48,Ambur,ASHOK KUMAR.C,Anaithu Makkal Puratchi Katchi,316,3,319,177878,236824,20232
48,Ambur,RAJINIKANTH.P,IND,252,1,253,177878,236824,20232
48,Ambur,MURUGAN.L,IND,199,2,201,177878,236824,20232
48,Ambur,GEORGE.V.A.,IND,159,1,160,177878,236824,20232
48,Ambur,PARTHIBAN.V,All India Youth Development Party,101,0,101,177878,236824,20232
48,Ambur,KAREEM BASHA.A,Rashtriya Ulama Council,81,1,82,177878,236824,20232
49,Jolarpet,DEVARAJI.K.,DMK,88237,1253,89490,196358,238470,1091
49,Jolarpet,VEERAMANI.K.C.,AIADMK,87365,1034,88399,196358,238470,1091
49,Jolarpet,SIVA.A.,NTK,13199,129,13328,196358,238470,1091
49,Jolarpet,NOTA,NOTA,1328,9,1337,196358,238470,1091
49,Jolarpet,KARUNANIDHI.R.,IND,1057,10,1067,196358,238470,1091
49,Jolarpet,KALASTHRI.S.,All India Uzhavargal Uzhaippalargal Katchi,861,9,870,196358,238470,1091
49,Jolarpet,THENNARASU SAAMRAJ,AMMK,614,5,619,196358,238470,1091
49,Jolarpet,SIVAKUMAR.V.C.,BSP,341,6,347,196358,238470,1091
49,Jolarpet,VEERAMANI.S.,IND,217,0,217,196358,238470,1091
49,Jolarpet,VEERAMANI.H.,IND,208,1,209,196358,238470,1091
49,Jolarpet,VEERAMANI.A.,IND,148,0,148,196358,238470,1091
49,Jolarpet,MANITHAN,IND,140,2,142,196358,238470,1091
49,Jolarpet,DEVARAJI.R.,IND,101,2,103,196358,238470,1091
49,Jolarpet,DEVARAJ.V.K.,IND,80,2,82,196358,238470,1091
50,Tirupattur,A. NALLATHAMBI,DMK,95067,1455,96522,185930,237682,28240
50,Tirupattur,T.K. RAJA,PMK,67905,377,68282,185930,237682,28240
50,Tirupattur,M. SUMATHI,NTK,12016,111,12127,185930,237682,28240
50,Tirupattur,A. GNANASEKAR,AMMK,2679,23,2702,185930,237682,28240
50,Tirupattur,NOTA,NOTA,1625,7,1632,185930,237682,28240
50,Tirupattur,B. VIJAYAKUMAR,IND,1091,5,1096,185930,237682,28240
50,Tirupattur,S. KALASHTHRI,All India Uzhavargal Uzhaippalargal Katchi,713,11,724,185930,237682,28240
50,Tirupattur,S. SATHIYAMOORTHY,Makkal Nala Kazhagam,516,3,519,185930,237682,28240
50,Tirupattur,R. AROCKIA JOE PRABU,IND,437,1,438,185930,237682,28240
50,Tirupattur,R. PALANI,IND,361,1,362,185930,237682,28240
50,Tirupattur,M. NALLASIVAM,IND,322,1,323,185930,237682,28240
50,Tirupattur,MANITHAN,IND,308,1,309,185930,237682,28240
50,Tirupattur,I. GOVINDARAJI,IND,296,1,297,185930,237682,28240
50,Tirupattur,I. ROSELIN JEEVA,Samaniya Makkal Nala Katchi,263,1,264,185930,237682,28240
50,Tirupattur,G. RAJA,IND,204,1,205,185930,237682,28240
50,Tirupattur,A. JEYAMMA,Anaithu Makkal Puratchi Katchi,127,1,128,185930,237682,28240
51,Uthangarai,T.M.TAMILSELVAM,AIADMK,98973,702,99675,188223,237077,-28387
51,Uthangarai,S.Arumugam,INC,70084,1204,71288,188223,237077,-28387
51,Uthangarai,Elangovan,NTK,10352,72,10424,188223,237077,-28387
51,Uthangarai,R.Bakyaraj,DMDK,2278,13,2291,188223,237077,-28387
51,Uthangarai,NOTA,NOTA,1354,5,1359,188223,237077,-28387
51,Uthangarai,K.Murugesan,MNM,1239,15,1254,188223,237077,-28387
51,Uthangarai,NAGARAJ,BSP,718,4,722,188223,237077,-28387
51,Uthangarai,C.Jayaraman,IND,322,0,322,188223,237077,-28387
51,Uthangarai,R.Vivekanandhan,IND,280,3,283,188223,237077,-28387
51,Uthangarai,S.Perumal,Anna Puratchi Thalaivar Amma Dravida Munnetra Kazhagam,205,1,206,188223,237077,-28387
51,Uthangarai,T.Tamilarasan,IND,180,1,181,188223,237077,-28387
51,Uthangarai,R.Manjunathan,IND,112,2,114,188223,237077,-28387
51,Uthangarai,M.Thenmozhi,IND,103,1,104,188223,237077,-28387
52,Bargur,MATHIAZHAGAN D,DMK,95852,1404,97256,197784,246282,12614
52,Bargur,KRISHNAN A,AIADMK,84177,465,84642,197784,246282,12614
52,Bargur,KARUNAKARAN K,NTK,10019,94,10113,197784,246282,12614
52,Bargur,NOTA,NOTA,1496,11,1507,197784,246282,12614
52,Bargur,GANESA KUMAR S,AMMK,1058,6,1064,197784,246282,12614
52,Bargur,NIRMALA A,National People's Party,701,9,710,197784,246282,12614
52,Bargur,MANJUNATHAN M,IND,622,1,623,197784,246282,12614
52,Bargur,MURALI M,BSP,442,1,443,197784,246282,12614
52,Bargur,ARUN GOWTHAM R,Indiya Jananayaka Katchi,337,8,345,197784,246282,12614
52,Bargur,MANI K,IND,327,0,327,197784,246282,12614
52,Bargur,SANTHAMOORTHI K,IND,223,0,223,197784,246282,12614
52,Bargur,VASANTHARAJ P,Anna Puratchi Thalaivar Amma Dravida Munnetra Kazhagam,181,3,184,197784,246282,12614
52,Bargur,AANDI A,Veerath Thiyagi Viswanathadoss Thozhilalarkal Katchi,120,1,121,197784,246282,12614
52,Bargur,KALPANA D,IND,115,4,119,197784,246282,12614
52,Bargur,KRISHNAN A,IND,106,1,107,197784,246282,12614
53,Krishnagiri,Ashokkumar.K,AIADMK,95300,750,96050,211648,265262,-794
53,Krishnagiri,SENGUTTUVAN.T,DMK,93507,1749,95256,211648,265262,-794
53,Krishnagiri,NIRANDARI.V,NTK,11009,128,11137,211648,265262,-794
53,Krishnagiri,RAVISHANKAR.R.K,MNM,3423,32,3455,211648,265262,-794
53,Krishnagiri,NOTA,NOTA,1827,10,1837,211648,265262,-794
53,Krishnagiri,CHANDRAMOHAN.K.M,Nationalist Congress Party,1072,16,1088,211648,265262,-794
53,Krishnagiri,AMEENULLA,All India Majlis-E-Ittehadul Muslimeen,851,7,858,211648,265262,-794
53,Krishnagiri,TAMILSELVAN.S,BSP,485,3,488,211648,265262,-794
53,Krishnagiri,SAKTHI.K,IND,417,1,418,211648,265262,-794
53,Krishnagiri,SIVAN.C,IND,314,4,318,211648,265262,-794
53,Krishnagiri,GOPINATH.M,IND,229,3,232,211648,265262,-794
53,Krishnagiri,VIJAYAKUMAR.R,Veerath Thiyagi Viswanathadoss Thozhilalarkal Katchi,133,4,137,211648,265262,-794
53,Krishnagiri,SASIKUMAR.K.S,Anna Puratchi Thalaivar Amma Dravida Munnetra Kazhagam,128,1,129,211648,265262,-794
53,Krishnagiri,TVS GANDHI,IND,97,0,97,211648,265262,-794
53,Krishnagiri,RUTHRAMANI.T,Desiya Makkal Sakthi Katchi,84,5,89,211648,265262,-794
53,Krishnagiri,KUMARESAN.M,IND,59,0,59,211648,265262,-794
54,Veppanahalli,K.P.Munusamy,AIADMK,93855,249,94104,205141,250671,-3054
54,Veppanahalli,P.Murugan,DMK,90593,457,91050,205141,250671,-3054
54,Veppanahalli,M.Sakthivel,NTK,8287,23,8310,205141,250671,-3054
54,Veppanahalli,S.M.Murugesan,DMDK,3592,9,3601,205141,250671,-3054
54,Veppanahalli,Abdul Azeez Amanullah,IND,3015,7,3022,205141,250671,-3054
54,Veppanahalli,NOTA,NOTA,1661,1,1662,205141,250671,-3054
54,Veppanahalli,P.Jayapal,MNM,667,5,672,205141,250671,-3054
54,Veppanahalli,Ramaswamy,IND,565,2,567,205141,250671,-3054
54,Veppanahalli,S.Thangapandiyan,Tamil Nadu Ilangyar Katchi,416,3,419,205141,250671,-3054
54,Veppanahalli,C.Chakkarlappa,IND,403,2,405,205141,250671,-3054
54,Veppanahalli,Lakshmanan Shanmugam,IND,376,2,378,205141,250671,-3054
54,Veppanahalli,K.P.U.UVARAJ,IND,285,0,285,205141,250671,-3054
54,Veppanahalli,M.Mariyappan,PT,225,1,226,205141,250671,-3054
54,Veppanahalli,Krishnamoorthy,IND,154,1,155,205141,250671,-3054
54,Veppanahalli,Usha,IND,146,8,154,205141,250671,-3054
54,Veppanahalli,Valli,Anna Puratchi Thalaivar Amma Dravida Munnetra Kazhagam,124,7,131,205141,250671,-3054
55,Hosur,PRAKAASH Y,DMK,117199,1032,118231,248098,349247,12367
55,Hosur,JYOTHI S,AIADMK,105475,389,105864,248098,349247,12367
55,Hosur,GEETHA LAKSHMI S,NTK,11391,31,11422,248098,349247,12367
55,Hosur,MASOOD S,MNM,6536,27,6563,248098,349247,12367
55,Hosur,NOTA,NOTA,1968,8,1976,248098,349247,12367
55,Hosur,MAREGOWDU M,AMMK,806,0,806,248098,349247,12367
55,Hosur,RAMASWAMY G C,IND,628,1,629,248098,349247,12367
55,Hosur,MUTHU R K,IND,585,0,585,248098,349247,12367
55,Hosur,EZHILAN S,Veerath Thiyagi Viswanathadoss Thozhilalarkal Katchi,460,2,462,248098,349247,12367
55,Hosur,MUTHAMIZH MUDHALVAN S,IND,395,2,397,248098,349247,12367
55,Hosur,LOKESH V,IND,361,0,361,248098,349247,12367
55,Hosur,SELVAM G,New Generation People’s Party,145,0,145,248098,349247,12367
55,Hosur,BALARAJU N,IND,132,0,132,248098,349247,12367
55,Hosur,SUNDAR L,Shiv Sena,127,0,127,248098,349247,12367
55,Hosur,SHANMUGAM R,IND,124,1,125,248098,349247,12367
55,Hosur,DEVAPPA Y,IND,80,1,81,248098,349247,12367
55,Hosur,GEETHA V,IND,72,1,73,248098,349247,12367
55,Hosur,JAYASEELAN G,Anna Puratchi Thalaivar Amma Dravida Munnetra Kazhagam,64,1,65,248098,349247,12367
55,Hosur,KISHORE KUMAR R,IND,54,0,54,248098,349247,12367
56,Thalli,RAMACHANDRAN.T,CPI,119621,1020,120641,194022,250602,56226
56,Thalli,Dr.NAGESH KUMAR.C,BJP,64131,284,64415,194022,250602,56226
56,Thalli,MARY SELVARANI.R,NTK,3760,16,3776,194022,250602,56226
56,Thalli,NOTA,NOTA,1963,3,1966,194022,250602,56226
56,Thalli,ASHOK KUMAR.V,Indiya Jananayaka Katchi,782,6,788,194022,250602,56226
56,Thalli,VASANTHAMMA.N,IND,582,2,584,194022,250602,56226
56,Thalli,KUMAR.M,IND,419,3,422,194022,250602,56226
56,Thalli,RAVI MUNISWAMY,IND,352,1,353,194022,250602,56226
56,Thalli,SEKAR.M.V,AMMK,342,4,346,194022,250602,56226
56,Thalli,DEVAPPA@DEVAGOWDA.Y,IND,219,3,222,194022,250602,56226
56,Thalli,USHA.M,New Generation People’s Party,208,1,209,194022,250602,56226
56,Thalli,RAVI.G,Samajwadi Party,162,0,162,194022,250602,56226
56,Thalli,JANAKI.G,Veerath Thiyagi Viswanathadoss Thozhilalarkal Katchi,137,1,138,194022,250602,56226
57,Palacode,ANBALAGAN.K.P.,AIADMK,109105,965,110070,206595,235094,-28100
57,Palacode,MURUGAN.P.K.,DMK,81035,935,81970,206595,235094,-28100
57,Palacode,KALAISELVI.G.,NTK,7647,57,7704,206595,235094,-28100
57,Palacode,VIJAYASANKAR.P.,DMDK,2394,15,2409,206595,235094,-28100
57,Palacode,NOTA,NOTA,1348,3,1351,206595,235094,-28100
57,Palacode,RAJASEKAR.D.,MNM,1168,8,1176,206595,235094,-28100
57,Palacode,HARI.R.,BSP,580,5,585,206595,235094,-28100
57,Palacode,VADIVEL.M.,IND,464,1,465,206595,235094,-28100
57,Palacode,RAJKUMAR.T.,IND,406,0,406,206595,235094,-28100
57,Palacode,MURUGAN.K.G.,IND,169,0,169,206595,235094,-28100
57,Palacode,MURUGAN.K.,IND,115,5,120,206595,235094,-28100
57,Palacode,SHARAVANAN.M.P.,IND,90,0,90,206595,235094,-28100
57,Palacode,ANBARASU.D.,IND,79,1,80,206595,235094,-28100
58,Pennagaram,MANI. G.K,PMK,105250,873,106123,210305,245342,-21186
58,Pennagaram,INBASEKARAN. P.N.P,DMK,83765,1172,84937,210305,245342,-21186
58,Pennagaram,TAMILAZHAGAN. R,NTK,8890,55,8945,210305,245342,-21186
58,Pennagaram,UTHAYAKUMAR. R,DMDK,2910,11,2921,210305,245342,-21186
58,Pennagaram,PERIYANANJAPPAN. A,IND,1959,9,1968,210305,245342,-21186
58,Pennagaram,NOTA,NOTA,1754,5,1759,210305,245342,-21186
58,Pennagaram,SHAKILA. K,MNM,1451,20,1471,210305,245342,-21186
58,Pennagaram,THIRUMURUGAN. P,IND,450,1,451,210305,245342,-21186
58,Pennagaram,MUNUSAMY. S,IND,263,2,265,210305,245342,-21186
58,Pennagaram,MOORTHI. S,BSP,238,7,245,210305,245342,-21186
58,Pennagaram,DHARUMAN. K,IND,242,1,243,210305,245342,-21186
58,Pennagaram,MANI. K.G.,IND,211,1,212,210305,245342,-21186
58,Pennagaram,ANNADURAI. C,Desiya Makkal Sakthi Katchi,208,3,211,210305,245342,-21186
58,Pennagaram,ANNADURAI. V,IND,207,0,207,210305,245342,-21186
58,Pennagaram,MANI. P,IND,202,3,205,210305,245342,-21186
58,Pennagaram,SIVALINGAM. N,IND,139,3,142,210305,245342,-21186
59,Dharmapuri,VENKATESHWARAN.S.P.,PMK,104415,1215,105630,217333,267999,-26860
59,Dharmapuri,SUBRAMANI.P,DMK,76846,1924,78770,217333,267999,-26860
59,Dharmapuri,RAJENDRAN.D.K.,AMMK,11166,60,11226,217333,267999,-26860
59,Dharmapuri,SENTHIL KUMAR (A) SENTHIL.A.,NTK,8609,91,8700,217333,267999,-26860
59,Dharmapuri,JAYAVENKATESAN.S.K.,MNM,5034,49,5083,217333,267999,-26860
59,Dharmapuri,NATARAJAN.M.,Anna Puratchi Thalaivar Amma Dravida Munnetra Kazhagam,1890,7,1897,217333,267999,-26860
59,Dharmapuri,NOTA,NOTA,1713,13,1726,217333,267999,-26860
59,Dharmapuri,NATARAJAN.V.,IND,716,2,718,217333,267999,-26860
59,Dharmapuri,TAMILARASAN.S.,IND,654,0,654,217333,267999,-26860
59,Dharmapuri,PERUMAL.P,BSP,462,2,464,217333,267999,-26860
59,Dharmapuri,SUBRAMANI.K.,IND,364,0,364,217333,267999,-26860
59,Dharmapuri,MANIGANDAN.E.V.,IND,355,2,357,217333,267999,-26860
59,Dharmapuri,SUBRAMANI.T.,IND,304,0,304,217333,267999,-26860
59,Dharmapuri,SHANMUGAM.P.,IND,236,1,237,217333,267999,-26860
59,Dharmapuri,SAKTHIVEL.P.,Desiya Makkal Sakthi Katchi,210,3,213,217333,267999,-26860
59,Dharmapuri,RAMASAMY.T.,My India Party,208,0,208,217333,267999,-26860
59,Dharmapuri,MANI.L.,Dhesiya Makkal Kazhagam,194,0,194,217333,267999,-26860
59,Dharmapuri,PALANI.S.K.,IND,160,0,160,217333,267999,-26860
59,Dharmapuri,SUNDARAMOORTHY.M.,IND,126,1,127,217333,267999,-26860
59,Dharmapuri,VENKATESWARAN.B.,IND,114,3,117,217333,267999,-26860
59,Dharmapuri,SUBRAMANI.P.,IND,110,0,110,217333,267999,-26860
59,Dharmapuri,RAJENDRAN.K.,IND,74,0,74,217333,267999,-26860
60,Pappireddippatti,GOVINDASAMY.A,AIADMK,113397,1110,114507,220994,263892,-36943
60,Pappireddippatti,PRABHURAJASEKAR.M,DMK,75831,1733,77564,220994,263892,-36943
60,Pappireddippatti,PALANIAPPAN.P,AMMK,15597,266,15863,220994,263892,-36943
60,Pappireddippatti,RAMESH.R,NTK,7490,83,7573,220994,263892,-36943
60,Pappireddippatti,SRINIVASAN,MNM,1720,9,1729,220994,263892,-36943
60,Pappireddippatti,NOTA,NOTA,1330,8,1338,220994,263892,-36943
60,Pappireddippatti,GOPI.K,BSP,623,2,625,220994,263892,-36943
60,Pappireddippatti,GOVINDASAMY.R,IND,426,6,432,220994,263892,-36943
60,Pappireddippatti,MURUGAN.S,IND,299,1,300,220994,263892,-36943
60,Pappireddippatti,VEERAMANI.T,IND,257,0,257,220994,263892,-36943
60,Pappireddippatti,ANAND KUMAR.K,IND,186,1,187,220994,263892,-36943
60,Pappireddippatti,MURUGAN.R,Anaithu Makkal Puratchi Katchi,149,1,150,220994,263892,-36943
60,Pappireddippatti,ELANGO.S,IND,130,0,130,220994,263892,-36943
60,Pappireddippatti,MANIVANNAN.K,IND,121,2,123,220994,263892,-36943
60,Pappireddippatti,PALANIYAPPAN.R,IND,120,2,122,220994,263892,-36943
60,Pappireddippatti,SELVAM.P,IND,89,5,94,220994,263892,-36943
61,Harur,SAMPATHKUMAR.V,AIADMK,98130,931,99061,198565,248622,-30362
61,Harur,KUMAR.A,CPM,67358,1341,68699,198565,248622,-30362
61,Harur,MURUGAN.R,AMMK,14161,166,14327,198565,248622,-30362
61,Harur,KEERTHANA.K,NTK,10830,120,10950,198565,248622,-30362
61,Harur,NOTA,NOTA,2232,17,2249,198565,248622,-30362
61,Harur,SIVAKUMAR.A,BSP,920,0,920,198565,248622,-30362
61,Harur,MURUGAN.R,IND,520,1,521,198565,248622,-30362
61,Harur,PARTHIPAN.P,IND,409,4,413,198565,248622,-30362
61,Harur,KARUTHOVIYAM.P,My India Party,377,5,382,198565,248622,-30362
61,Harur,SATHISKUMAR.S,Indiya Jananayaka Katchi,275,7,282,198565,248622,-30362
61,Harur,KUMAR.P,IND,263,2,265,198565,248622,-30362
61,Harur,PALANI.C,IND,172,1,173,198565,248622,-30362
61,Harur,CHINNASAMY.K,Dhesiya Makkal Kazhagam,168,1,169,198565,248622,-30362
61,Harur,SARATHKUMAR.M,IND,153,1,154,198565,248622,-30362
62,Chengam,GIRI.M.P,DMK,106185,1896,108081,223950,273460,11570
62,Chengam,NAINAKANNU.M.S,AIADMK,95280,1231,96511,223950,273460,11570
62,Chengam,VENNILA.S,NTK,11980,100,12080,223950,273460,11570
62,Chengam,ANBU.S,DMDK,2741,28,2769,223950,273460,11570
62,Chengam,NOTA,NOTA,1079,6,1085,223950,273460,11570
62,Chengam,SUGANRAJ.S,Indiya Jananayaka Katchi,823,5,828,223950,273460,11570
62,Chengam,SHANMUGAM.G,BSP,790,11,801,223950,273460,11570
62,Chengam,VIJAYACHANDRAN.G,IND,417,0,417,223950,273460,11570
62,Chengam,SELVARAJI.V,IND,379,2,381,223950,273460,11570
62,Chengam,DHINAKARAN.H,IND,200,0,200,223950,273460,11570
62,Chengam,BASKAR.S,New Generation People’s Party,171,3,174,223950,273460,11570
62,Chengam,SIVAPRAKASH.K,IND,139,34,173,223950,273460,11570
62,Chengam,SHARMA.S,IND,85,42,127,223950,273460,11570
62,Chengam,ARUNKUMAR.M,IND,111,1,112,223950,273460,11570
62,Chengam,ANBAZHAGAN.P.G,IND,110,2,112,223950,273460,11570
62,Chengam,SIVAKUMAR.J,IND,99,0,99,223950,273460,11570
63,Tiruvannamalai,E V VELU,DMK,134987,2889,137876,208836,284927,94673
63,Tiruvannamalai,S THANIGAIVEL,BJP,42836,367,43203,208836,284927,94673
63,Tiruvannamalai,J KAMALAKKANNAN,NTK,13894,101,13995,208836,284927,94673
63,Tiruvannamalai,ARUL R,MNM,6169,77,6246,208836,284927,94673
63,Tiruvannamalai,NOTA,NOTA,2170,24,2194,208836,284927,94673
63,Tiruvannamalai,A G PANCHATCHARAM,AMMK,2088,20,2108,208836,284927,94673
63,Tiruvannamalai,J JAMEEL BASHA,IND,774,6,780,208836,284927,94673
63,Tiruvannamalai,J AGNI SELVARASU,Naadaalum Makkal Katchi,545,3,548,208836,284927,94673
63,Tiruvannamalai,KOTHANDAPANI,BSP,460,6,466,208836,284927,94673
63,Tiruvannamalai,K VINAYAGAM,IND,430,0,430,208836,284927,94673
63,Tiruvannamalai,R G VASUDEVAN,IND,291,0,291,208836,284927,94673
63,Tiruvannamalai,N PALANI,IND,145,19,164,208836,284927,94673
63,Tiruvannamalai,D MANIMARAN,IND,152,5,157,208836,284927,94673
63,Tiruvannamalai,A NAKKEERAN,IND,142,4,146,208836,284927,94673
63,Tiruvannamalai,S K SELVAM,Veerath Thiyagi Viswanathadoss Thozhilalarkal Katchi,130,1,131,208836,284927,94673
63,Tiruvannamalai,R CHANDRAKANTH PILLAI,New Generation People’s Party,98,3,101,208836,284927,94673
64,Kilpennathur,K.Pitchandi,DMK,102713,1962,104675,203886,252091,26787
64,Kilpennathur,K.Selvakumar,PMK,76854,1034,77888,203886,252091,26787
64,Kilpennathur,Dr.R.Rameshbabu,NTK,11464,77,11541,203886,252091,26787
64,Kilpennathur,P.Kathikeyan,AMMK,2172,19,2191,203886,252091,26787
64,Kilpennathur,V.Suganantham,MNM,1431,6,1437,203886,252091,26787
64,Kilpennathur,NOTA,NOTA,954,7,961,203886,252091,26787
64,Kilpennathur,M.Murugan,IND,835,9,844,203886,252091,26787
64,Kilpennathur,SubashChandrabose,BSP,593,5,598,203886,252091,26787
64,Kilpennathur,S.Sasikumar,IND,592,5,597,203886,252091,26787
64,Kilpennathur,A.R.Elumalai,Veerath Thiyagi Viswanathadoss Thozhilalarkal Katchi,497,7,504,203886,252091,26787
64,Kilpennathur,M.Sampathraj,IND,415,2,417,203886,252091,26787
64,Kilpennathur,Sakthivel,IND,407,1,408,203886,252091,26787
64,Kilpennathur,N.Thangaraj,Makkal Munnetra Peravai,313,4,317,203886,252091,26787
64,Kilpennathur,M.Dinakaran,IND,251,20,271,203886,252091,26787
64,Kilpennathur,Farmer Jayaraman,Anaithu Makkal Arasiyal Katchi,236,3,239,203886,252091,26787
64,Kilpennathur,P.Ganeshraja,IND,194,3,197,203886,252091,26787
64,Kilpennathur,M.Athiyaman,IND,185,0,185,203886,252091,26787
64,Kilpennathur,C.Jothi,IND,151,1,152,203886,252091,26787
64,Kilpennathur,A.Venkatesan,Republican Party of India (Athawale),147,0,147,203886,252091,26787
64,Kilpennathur,G.krishnamurthy,IND,86,39,125,203886,252091,26787
64,Kilpennathur,M.Mohanraja,IND,117,0,117,203886,252091,26787
64,Kilpennathur,Lourdammal,IND,75,0,75,203886,252091,26787
65,Kalasapakkam,Saravanan.P.S.T,DMK,92712,1422,94134,196434,241983,9222
65,Kalasapakkam,Panneerselvam.V,AIADMK,84070,842,84912,196434,241983,9222
65,Kalasapakkam,Balaji.E,NTK,8748,74,8822,196434,241983,9222
65,Kalasapakkam,Nehru.M,DMDK,2738,18,2756,196434,241983,9222
65,Kalasapakkam,NOTA,NOTA,1584,9,1593,196434,241983,9222
65,Kalasapakkam,Tirunavukarasu.M,IND,755,10,765,196434,241983,9222
65,Kalasapakkam,Panneerselvam.S,IND,710,3,713,196434,241983,9222
65,Kalasapakkam,Rajkumar.E,BSP,623,9,632,196434,241983,9222
65,Kalasapakkam,Rajamani.K,IND,449,1,450,196434,241983,9222
65,Kalasapakkam,Amutha.G,IND,362,20,382,196434,241983,9222
65,Kalasapakkam,Jagannathan.R,IND,321,1,322,196434,241983,9222
65,Kalasapakkam,Saravanan.K,IND,244,6,250,196434,241983,9222
65,Kalasapakkam,Rajendran.M.S,Indiya Jananayaka Katchi,239,5,244,196434,241983,9222
65,Kalasapakkam,Panneerselvam.V,IND,238,1,239,196434,241983,9222
65,Kalasapakkam,Kalyanasundaram.A,Veerath Thiyagi Viswanathadoss Thozhilalarkal Katchi,126,2,128,196434,241983,9222
65,Kalasapakkam,Sampath.R.V,Anna Dravidar Kazhagam,91,1,92,196434,241983,9222
66,Polur,Agri KRISHNAMURTHY. S S,AIADMK,96878,854,97732,202012,242930,-9725
66,Polur,SEKARAN. K.V,DMK,86544,1463,88007,202012,242930,-9725
66,Polur,LAVANYA. L,NTK,10065,132,10197,202012,242930,-9725
66,Polur,KALAVATHI. G,MNM,1561,19,1580,202012,242930,-9725
66,Polur,DAKSNAMOORTHY. R,IND,1188,0,1188,202012,242930,-9725
66,Polur,NOTA,NOTA,1131,13,1144,202012,242930,-9725
66,Polur,VIJAYAKUMAR. C,AMMK,646,10,656,202012,242930,-9725
66,Polur,Ezhilarasu. M,BSP,600,4,604,202012,242930,-9725
66,Polur,MURUGESAN. D,IND,278,0,278,202012,242930,-9725
66,Polur,SIVA. A,IND,216,0,216,202012,242930,-9725
66,Polur,Shanmugasundaram. E,IND,82,8,90,202012,242930,-9725
66,Polur,SATHIYARAJ. P,IND,77,10,87,202012,242930,-9725
66,Polur,CHIDAMBARAM. V,IND,71,1,72,202012,242930,-9725
66,Polur,KALAIMANI. S,IND,56,0,56,202012,242930,-9725
66,Polur,GANESAN. C,IND,55,0,55,202012,242930,-9725
66,Polur,KRISHNAMURTHI. K,IND,50,0,50,202012,242930,-9725
67,Arani,S.RAMACHANDRAN,AIADMK,102225,736,102961,221422,275097,-3128
67,Arani,S.S.ANBALAGAN,DMK,98386,1447,99833,221422,275097,-3128
67,Arani,D.PRAKALATHA,NTK,10373,118,10491,221422,275097,-3128
67,Arani,V.MANIGANDAN,MNM,2196,17,2213,221422,275097,-3128
67,Arani,G.BASKARAN,DMDK,1852,9,1861,221422,275097,-3128
67,Arani,NOTA,NOTA,1666,24,1690,221422,275097,-3128
67,Arani,S.THANIGAIVEL,Veerath Thiyagi Viswanathadoss Thozhilalarkal Katchi,506,3,509,221422,275097,-3128
67,Arani,N.KARTHIKEYAN,IND,395,2,397,221422,275097,-3128
67,Arani,K.ANBU,BSP,330,2,332,221422,275097,-3128
67,Arani,R.DHAKSHANAMOORTHY,IND,313,0,313,221422,275097,-3128
67,Arani,A.ARUNKUMAR,IND,217,5,222,221422,275097,-3128
67,Arani,S.SAKTHIVEL,IND,165,13,178,221422,275097,-3128
67,Arani,S.RAMACHANDRAN,IND,133,1,134,221422,275097,-3128
67,Arani,S.MURALI,IND,133,0,133,221422,275097,-3128
67,Arani,M.ANBALAGAN,IND,78,2,80,221422,275097,-3128
67,Arani,K.ANBALAGAN,IND,56,19,75,221422,275097,-3128
68,Cheyyar,JOTHI. O,DMK,101080,1380,102460,214460,259242,12271
68,Cheyyar,DUSI. K. MOHAN,AIADMK,89469,720,90189,214460,259242,12271
68,Cheyyar,BHEEMAN. G,NTK,12112,80,12192,214460,259242,12271
68,Cheyyar,MAYILVAGANAN. T,MNM,2403,26,2429,214460,259242,12271
68,Cheyyar,NOTA,NOTA,1882,13,1895,214460,259242,12271
68,Cheyyar,VARADHARAJAN. M. K,AMMK,1748,12,1760,214460,259242,12271
68,Cheyyar,SURESH BABU. T,IND,731,2,733,214460,259242,12271
68,Cheyyar,VIJAYAKANTH. S,BSP,726,5,731,214460,259242,12271
68,Cheyyar,KUTTIMANI. S,Veerath Thiyagi Viswanathadoss Thozhilalarkal Katchi,503,1,504,214460,259242,12271
68,Cheyyar,UDHAYAKUMAR. M,IND,289,1,290,214460,259242,12271
68,Cheyyar,ANANDASEKARAN. C,IND,286,2,288,214460,259242,12271
68,Cheyyar,NIRMALA. V,IND,281,1,282,214460,259242,12271
68,Cheyyar,MANIKANDAN. M,Ganasangam Party of India,259,3,262,214460,259242,12271
68,Cheyyar,NADARAJAN. B,New Generation People’s Party,189,1,190,214460,259242,12271
68,Cheyyar,MARYVOILET. J,Desiya Sirupanmayinar Makkal Iyakkam,131,12,143,214460,259242,12271
68,Cheyyar,VENKATESAN .V,Anaithindia Samudaya Munnetra Kazhagam,100,12,112,214460,259242,12271
69,Vandavasi,Ambethkumar S,DMK,100951,1113,102064,185974,239670,35953
69,Vandavasi,Murali S,PMK,65617,494,66111,185974,239670,35953
69,Vandavasi,Prabavathi G,NTK,9249,35,9284,185974,239670,35953
69,Vandavasi,NOTA,NOTA,1759,10,1769,185974,239670,35953
69,Vandavasi,Venkatesan P,AMMK,1714,14,1728,185974,239670,35953
69,Vandavasi,Suresh S,MNM,1678,14,1692,185974,239670,35953
69,Vandavasi,Manikandan K,IND,1262,2,1264,185974,239670,35953
69,Vandavasi,Arjunan M,BSP,597,10,607,185974,239670,35953
69,Vandavasi,Vignesh S,IND,540,6,546,185974,239670,35953
69,Vandavasi,Murali C,IND,406,1,407,185974,239670,35953
69,Vandavasi,Durai B,Ganasangam Party of India,360,3,363,185974,239670,35953
69,Vandavasi,Muthuperumal K,IND,136,3,139,185974,239670,35953
70,Gingee,MASTHAN K S,DMK,107683,1942,109625,206880,260165,35803
70,Gingee,RAJENDIRAN P,PMK,73078,744,73822,206880,260165,35803
70,Gingee,SUGUMAR AP,NTK,9860,60,9920,206880,260165,35803
70,Gingee,GOWTHAM SAGAR A,AMMK,4751,60,4811,206880,260165,35803
70,Gingee,NOTA,NOTA,2275,4,2279,206880,260165,35803
70,Gingee,SRIPATHI P,MNM,2137,14,2151,206880,260165,35803
70,Gingee,GOPI S,IND,1911,3,1914,206880,260165,35803
70,Gingee,JAGAJANANDAM  R,BSP,632,5,637,206880,260165,35803
70,Gingee,VARTHAMANAN B,IND,554,5,559,206880,260165,35803
70,Gingee,ELUMALAI N A,Anna Dravidar Kazhagam,401,9,410,206880,260165,35803
70,Gingee,MARIYAPPAN S,IND,245,1,246,206880,260165,35803
70,Gingee,KIRUBAKARAN T,IND,179,2,181,206880,260165,35803
70,Gingee,SAHEERA,IND,167,1,168,206880,260165,35803
70,Gingee,SENJIRAJA KNK,IND,156,1,157,206880,260165,35803
71,Mailam,SIVAKUMAR C,PMK,80203,841,81044,176989,219879,-2230
71,Mailam,Dr. MASILAMANI R,DMK,77899,915,78814,176989,219879,-2230
71,Mailam,UMAMAHESWARI L,NTK,8315,25,8340,176989,219879,-2230
71,Mailam,SUNDARESAN A,DMDK,3913,8,3921,176989,219879,-2230
71,Mailam,NOTA,NOTA,882,2,884,176989,219879,-2230
71,Mailam,MASILAMANI V,IND,805,2,807,176989,219879,-2230
71,Mailam,DURAI M,BSP,647,1,648,176989,219879,-2230
71,Mailam,RAJASEKAR M,IND,641,6,647,176989,219879,-2230
71,Mailam,MASILAMANI V,IND,519,5,524,176989,219879,-2230
71,Mailam,MANAVALAN A,Anna MGR Dravida Makkal Kalgam,373,4,377,176989,219879,-2230
71,Mailam,SRIDHAR D,IND,343,1,344,176989,219879,-2230
71,Mailam,CHANDRA PRAKASH R,IND,249,0,249,176989,219879,-2230
71,Mailam,SATHIYARAJ S,IND,144,0,144,176989,219879,-2230
71,Mailam,SEKAR NAYAKKAR I M,IND,137,0,137,176989,219879,-2230
71,Mailam,KANNAN G,IND,109,0,109,176989,219879,-2230
72,Tindivanam,ARJUNAN P,AIADMK,86155,997,87152,182538,229928,-9753
72,Tindivanam,SEETHAPATHY P,DMK,76038,1361,77399,182538,229928,-9753
72,Tindivanam,PACHIMUTHU P,NTK,9162,41,9203,182538,229928,-9753
72,Tindivanam,CHANDRALEKHA K,DMDK,2678,23,2701,182538,229928,-9753
72,Tindivanam,POYATHU @ ANBIN POYYAMOZHI S,MNM,2068,11,2079,182538,229928,-9753
72,Tindivanam,NOTA,NOTA,1514,9,1523,182538,229928,-9753
72,Tindivanam,GOVINDASAMY A,BSP,599,4,603,182538,229928,-9753
72,Tindivanam,ILAVARASAN K,Anna Dravidar Kazhagam,424,0,424,182538,229928,-9753
72,Tindivanam,THAMBIRAJ A,IND,378,1,379,182538,229928,-9753
72,Tindivanam,SETTU M,Desiya Sirupanmayinar Makkal Iyakkam,247,0,247,182538,229928,-9753
72,Tindivanam,VETRIVENDHAN S,IND,195,0,195,182538,229928,-9753
72,Tindivanam,VISWANATHAN S A,All  India  Pattali  Munnetra Katchi,148,0,148,182538,229928,-9753
72,Tindivanam,GOKULAKRISHNAN M,IND,132,9,141,182538,229928,-9753
72,Tindivanam,ARULMARAN J,IND,120,2,122,182538,229928,-9753
72,Tindivanam,MOHAN A,MAKKAL SAKTHI KATCHI,108,4,112,182538,229928,-9753
72,Tindivanam,VINOTH S,IND,110,0,110,182538,229928,-9753
73,Vanur,CHAKRAPANI M,AIADMK,91501,718,92219,182208,225732,-21727
73,Vanur,VANNI ARASU,VCK,69843,649,70492,182208,225732,-21727
73,Vanur,LATCHOUMY M,NTK,8537,50,8587,182208,225732,-21727
73,Vanur,GANAPATHI P M,DMDK,5430,30,5460,182208,225732,-21727
73,Vanur,SANDOSHKUMAR M,MNM,2492,8,2500,182208,225732,-21727
73,Vanur,NOTA,NOTA,1356,7,1363,182208,225732,-21727
73,Vanur,SAKTHIVEL S,IND,811,2,813,182208,225732,-21727
73,Vanur,VINAYAGAMURTHY M,BSP,765,9,774,182208,225732,-21727
74,Villupuram,LAKSHMANAN R,DMK,100423,1848,102271,204860,260995,14868
74,Villupuram,SHANMUGAM C Ve,AIADMK,86368,1035,87403,204860,260995,14868
74,Villupuram,SELVAM J,NTK,6314,61,6375,204860,260995,14868
74,Villupuram,DASS K,MNM,3207,35,3242,204860,260995,14868
74,Villupuram,BALASUNDARAM R,AMMK,1684,11,1695,204860,260995,14868
74,Villupuram,NOTA,NOTA,960,10,970,204860,260995,14868
74,Villupuram,SHANMUGAM A,IND,491,0,491,204860,260995,14868
74,Villupuram,SIVABALAN N,BSP,412,3,415,204860,260995,14868
74,Villupuram,SHANMUGAM G,IND,371,0,371,204860,260995,14868
74,Villupuram,DURAISAMY D,Makkal Munnetra Peravai,318,4,322,204860,260995,14868
74,Villupuram,KESAVAN P,IND,321,0,321,204860,260995,14868
74,Villupuram,SHANMUGAM V,IND,233,0,233,204860,260995,14868
74,Villupuram,DEVANATHAN N,Veerath Thiyagi Viswanathadoss Thozhilalarkal Katchi,118,0,118,204860,260995,14868
74,Villupuram,JAIAADHE R,IND,84,0,84,204860,260995,14868
74,Villupuram,VICTOR A S,Desiya Sirupanmayinar Makkal Iyakkam,78,0,78,204860,260995,14868
74,Villupuram,RAMAN K,IND,78,0,78,204860,260995,14868
74,Villupuram,KUPPAN V,IND,67,0,67,204860,260995,14868
74,Villupuram,KUMAR R,IND,66,0,66,204860,260995,14868
74,Villupuram,DAKSHINAMOORTHY SU VA,IND,47,1,48,204860,260995,14868
74,Villupuram,BALU K,IND,42,0,42,204860,260995,14868
74,Villupuram,PRABAKARAN M,IND,35,0,35,204860,260995,14868
74,Villupuram,IYYANAR G,IND,34,0,34,204860,260995,14868
74,Villupuram,MOHAMED IBRAIM A,Anna Dravidar Kazhagam,32,0,32,204860,260995,14868
74,Villupuram,SUBRAMANIAN R,IND,25,2,27,204860,260995,14868
74,Villupuram,NARENDIRAN D,IND,23,0,23,204860,260995,14868
74,Villupuram,INIYADAYALAN G,IND,19,0,19,204860,260995,14868
75,Vikravandi,PUGAZHENTHI N,DMK,92621,1109,93730,193617,233903,9573
75,Vikravandi,MUTHAMILSELVAN R,AIADMK,83258,899,84157,193617,233903,9573
75,Vikravandi,SHEEBA ASHMI R,NTK,8141,75,8216,193617,233903,9573
75,Vikravandi,IYYANAR R,AMMK,3039,14,3053,193617,233903,9573
75,Vikravandi,NOTA,NOTA,1108,14,1122,193617,233903,9573
75,Vikravandi,RAGHUPATHY P,IND,906,1,907,193617,233903,9573
75,Vikravandi,ELANGOVAN S,Akhil Bharat Hindu Mahasabha,652,3,655,193617,233903,9573
75,Vikravandi,ARUMUGAM C,BSP,517,3,520,193617,233903,9573
75,Vikravandi,SATHISH R,IND,436,0,436,193617,233903,9573
75,Vikravandi,GAYATHRI J,IND,303,2,305,193617,233903,9573
75,Vikravandi,SENTHIL R,Indiya Jananayaka Katchi,204,3,207,193617,233903,9573
75,Vikravandi,RAJIVGANDHI P,Naadaalum Makkal Katchi,95,1,96,193617,233903,9573
75,Vikravandi,KANNADHASAN A,IND,73,8,81,193617,233903,9573
75,Vikravandi,AYYANAR A,IND,75,3,78,193617,233903,9573
75,Vikravandi,IYYAPPAN K,IND,54,0,54,193617,233903,9573
76,Tirukkoyilur,K.PONMUDY,DMK,109226,1754,110980,196217,253982,59680
76,Tirukkoyilur,VAT.KALIVARADHAN,BJP,50887,413,51300,196217,253982,59680
76,Tirukkoyilur,L.VENKATESAN,DMDK,13928,69,13997,196217,253982,59680
76,Tirukkoyilur,MURUGAN S,NTK,11567,53,11620,196217,253982,59680
76,Tirukkoyilur,NOTA,NOTA,2030,9,2039,196217,253982,59680
76,Tirukkoyilur,VIGNESH M,IND,1482,0,1482,196217,253982,59680
76,Tirukkoyilur,SENTHILKUMAR M,Indiya Jananayaka Katchi,1056,10,1066,196217,253982,59680
76,Tirukkoyilur,PRAKASH A,IND,881,2,883,196217,253982,59680
76,Tirukkoyilur,SIVA.PANJAVARNAM,BSP,691,5,696,196217,253982,59680
76,Tirukkoyilur,SANKAR S,Veerath Thiyagi Viswanathadoss Thozhilalarkal Katchi,565,1,566,196217,253982,59680
76,Tirukkoyilur,JAYAVINDAN G,IND,480,0,480,196217,253982,59680
76,Tirukkoyilur,MATHIVANAN S,IND,412,0,412,196217,253982,59680
76,Tirukkoyilur,MAGESH M,IND,271,5,276,196217,253982,59680
76,Tirukkoyilur,RAJINI VR,Naadaalum Makkal Katchi,231,0,231,196217,253982,59680
76,Tirukkoyilur,KATHIRAVAN K,IND,183,6,189,196217,253982,59680
77,Ulundurpettai,MANIKANNAN A J,DMK,114344,1107,115451,244853,292954,5256
77,Ulundurpettai,KUMARAGURU R,AIADMK,108960,1235,110195,244853,292954,5256
77,Ulundurpettai,Pushbamary L,NTK,8954,46,9000,244853,292954,5256
77,Ulundurpettai,K.G.P.Rajamani,AMMK,2843,5,2848,244853,292954,5256
77,Ulundurpettai,NOTA,NOTA,2277,3,2280,244853,292954,5256
77,Ulundurpettai,MANIKANNAN M,IND,2106,1,2107,244853,292954,5256
77,Ulundurpettai,SATHIYAMOORTHY,BSP,823,2,825,244853,292954,5256
77,Ulundurpettai,CHINNAIYAN S,MNM,673,4,677,244853,292954,5256
77,Ulundurpettai,RAJASTALIN K,IND,351,1,352,244853,292954,5256
77,Ulundurpettai,MANI R,Veerath Thiyagi Viswanathadoss Thozhilalarkal Katchi,298,1,299,244853,292954,5256
77,Ulundurpettai,DEEPA,My India Party,263,0,263,244853,292954,5256
77,Ulundurpettai,VENkATESAN M,CPI(ML)(L),140,3,143,244853,292954,5256
77,Ulundurpettai,RAJAMANI  K,IND,116,1,117,244853,292954,5256
77,Ulundurpettai,KUMAR A,Indhia Kudiarasu Katchi,110,0,110,244853,292954,5256
77,Ulundurpettai,KATHIRVEL M,IND,102,3,105,244853,292954,5256
77,Ulundurpettai,DHANAPAL P,Lok Jan Shakti Party,81,0,81,244853,292954,5256
78,Rishivandiyam,KARTHIKEYAN K,DMK,112998,914,113912,215106,267584,41728
78,Rishivandiyam,SANTHOSH S A,AIADMK,71921,263,72184,215106,267584,41728
78,Rishivandiyam,SURESH MANIVANNAN R,NTK,12041,25,12066,215106,267584,41728
78,Rishivandiyam,PRABHU S,AMMK,10367,20,10387,215106,267584,41728
78,Rishivandiyam,NOTA,NOTA,2419,1,2420,215106,267584,41728
78,Rishivandiyam,MURUGAN K,IND,1508,0,1508,215106,267584,41728
78,Rishivandiyam,SHANMUGASUNDARAM K,MNM,637,3,640,215106,267584,41728
78,Rishivandiyam,VEERAN S,BSP,424,2,426,215106,267584,41728
78,Rishivandiyam,SANTHOSH M,IND,308,0,308,215106,267584,41728
78,Rishivandiyam,CHANDRASEKARAN V,IND,287,0,287,215106,267584,41728
78,Rishivandiyam,GURU K,IND,267,1,268,215106,267584,41728
78,Rishivandiyam,TAMILVANAN M,My India Party,150,1,151,215106,267584,41728
78,Rishivandiyam,VENKATRAMAN J,Naadaalum Makkal Katchi,149,0,149,215106,267584,41728
78,Rishivandiyam,NARAYANAN A,Anna MGR Dravida Makkal Kalgam,141,1,142,215106,267584,41728
78,Rishivandiyam,RADHAKRISHNAN K,Makkal Munnetra Peravai,127,2,129,215106,267584,41728
78,Rishivandiyam,KARTHIK G,IND,129,0,129,215106,267584,41728
79,Sankarapuram,UDHAYASURIYAN T,DMK,119487,1699,121186,215802,267989,45963
79,Sankarapuram,Dr.RAJA G,PMK,74702,521,75223,215802,267989,45963
79,Sankarapuram,RAJIYAMA B,NTK,9824,49,9873,215802,267989,45963
79,Sankarapuram,ARUL P,IND,2119,1,2120,215802,267989,45963
79,Sankarapuram,MANNAN M P,IND,1155,1,1156,215802,267989,45963
79,Sankarapuram,NOTA,NOTA,944,9,953,215802,267989,45963
79,Sankarapuram,MAYILAMPARAI MARI A,IND,844,0,844,215802,267989,45963
79,Sankarapuram,Sakthivel S,BSP,807,3,810,215802,267989,45963
79,Sankarapuram,VIMALAMARY S,Anna MGR Dravida Makkal Kalgam,603,6,609,215802,267989,45963
79,Sankarapuram,RAMESH G,Indiya Jananayaka Katchi,458,2,460,215802,267989,45963
79,Sankarapuram,KUBENDIRAN A,IND,428,0,428,215802,267989,45963
79,Sankarapuram,MUJIBUR RAGIMAN M,All India Majlis-E-Ittehadul Muslimeen,377,2,379,215802,267989,45963
79,Sankarapuram,DHANAM K,IND,348,0,348,215802,267989,45963
79,Sankarapuram,BABUGANESH S,IND,292,1,293,215802,267989,45963
79,Sankarapuram,GOPINATH E,IND,272,0,272,215802,267989,45963
79,Sankarapuram,OVIYAR ANANDH C,Lok Jan Shakti Party,256,1,257,215802,267989,45963
79,Sankarapuram,ARUNKENNADI A P,All  India  Pattali  Munnetra Katchi,203,0,203,215802,267989,45963
79,Sankarapuram,UTHAYAKUMAR A,IND,165,1,166,215802,267989,45963
79,Sankarapuram,JAYAPRAKASH K,IND,134,0,134,215802,267989,45963
79,Sankarapuram,RAJKUMAR  E,IND,88,0,88,215802,267989,45963
80,Kallakurichi,Senthilkumar.M,AIADMK,109909,734,110643,225858,284901,-25891
80,Kallakurichi,Manirathinem.K.I,INC,83367,1385,84752,225858,284901,-25891
80,Kallakurichi,Dravidamuthamilselvi.D,NTK,16409,65,16474,225858,284901,-25891
80,Kallakurichi,Vijayakumar.N,DMDK,6555,16,6571,225858,284901,-25891
80,Kallakurichi,NOTA,NOTA,1247,10,1257,225858,284901,-25891
80,Kallakurichi,Devimangayarkarasi.K,IND,1197,0,1197,225858,284901,-25891
80,Kallakurichi,Palanisamy.A,BSP,1096,1,1097,225858,284901,-25891
80,Kallakurichi,Prabu.C,IND,937,0,937,225858,284901,-25891
80,Kallakurichi,Ayyasamy.M,Indiya Jananayaka Katchi,864,7,871,225858,284901,-25891
80,Kallakurichi,Suriyaprakash.M,IND,655,4,659,225858,284901,-25891
80,Kallakurichi,Selvaraj.M,IND,265,1,266,225858,284901,-25891
80,Kallakurichi,Subramaniyan.P,IND,248,2,250,225858,284901,-25891
80,Kallakurichi,Dinesh.M,My India Party,197,1,198,225858,284901,-25891
80,Kallakurichi,Elaiyaperumal.K,IND,185,0,185,225858,284901,-25891
80,Kallakurichi,Kuppusamy.K,Anna MGR Dravida Makkal Kalgam,171,0,171,225858,284901,-25891
80,Kallakurichi,Sivakumar.S,IND,125,0,125,225858,284901,-25891
80,Kallakurichi,Gurusamy.M,IND,103,0,103,225858,284901,-25891
80,Kallakurichi,Oviyar Ananth,Lok Jan Shakti Party,102,0,102,225858,284901,-25891
81,Gangavalli,"NALLATHAMBI,A.",AIADMK,88900,668,89568,186503,238260,-7361
81,Gangavalli,"REKHA PRIYADHARSHINI,J.",DMK,80466,1741,82207,186503,238260,-7361
81,Gangavalli,"VINOTHINI,R.",NTK,9241,82,9323,186503,238260,-7361
81,Gangavalli,"PANDIAN,A.",AMMK,1497,22,1519,186503,238260,-7361
81,Gangavalli,NOTA,NOTA,1241,10,1251,186503,238260,-7361
81,Gangavalli,"NAVAN,P.",PT,603,6,609,186503,238260,-7361
81,Gangavalli,"PERIYASAMY,K.",Indiya Jananayaka Katchi,488,5,493,186503,238260,-7361
81,Gangavalli,"SELLAMMAL,V.M.",BSP,481,4,485,186503,238260,-7361
81,Gangavalli,"SARAVANAN,R.",IND,396,0,396,186503,238260,-7361
81,Gangavalli,"SENTHILKUMAR,K.",IND,392,0,392,186503,238260,-7361
81,Gangavalli,"CHANDRASEKARAN,K.",IND,155,0,155,186503,238260,-7361
81,Gangavalli,"AYYADURAI,J.",IND,104,1,105,186503,238260,-7361
82,Attur,"JAYASANKARAN, A.P.",AIADMK,94262,1046,95308,199743,253809,-8257
82,Attur,"CHINNADURAI, K.",DMK,85243,1808,87051,199743,253809,-8257
82,Attur,"KRISHNAVENI, S.",NTK,10141,92,10233,199743,253809,-8257
82,Attur,"SIVAKUMAR, P.",MNM,1937,22,1959,199743,253809,-8257
82,Attur,NOTA,NOTA,1817,17,1834,199743,253809,-8257
82,Attur,"MADHESWARAN, S.",AMMK,1675,24,1699,199743,253809,-8257
82,Attur,"PERIYANNAN, M.",BSP,492,2,494,199743,253809,-8257
82,Attur,"ARUMUGAM, D.",IND,367,0,367,199743,253809,-8257
82,Attur,"SADHA SIVAM, R.",Ambedkarite Party of India,240,1,241,199743,253809,-8257
82,Attur,"SILAMBARASAN, J.",IND,222,0,222,199743,253809,-8257
82,Attur,"JANARTHANAM, A.",Dhesiya Makkal Kazhagam,215,0,215,199743,253809,-8257
82,Attur,"MATHESWARI, K.K.",Anna Dravidar Kazhagam,117,3,120,199743,253809,-8257
83,Yercaud,G. Chitra,AIADMK,120542,1019,121561,238924,282692,-25955
83,Yercaud,C. TAMILSELVAN,DMK,93927,1679,95606,238924,282692,-25955
83,Yercaud,Jothi,NTK,13214,94,13308,238924,282692,-25955
83,Yercaud,C. KUMAR,DMDK,2962,24,2986,238924,282692,-25955
83,Yercaud,NOTA,NOTA,1955,24,1979,238924,282692,-25955
83,Yercaud,T. Duraisamy,Indiya Jananayaka Katchi,870,6,876,238924,282692,-25955
83,Yercaud,D. MADESH,IND,659,1,660,238924,282692,-25955
83,Yercaud,P. Ramasamy,BSP,579,0,579,238924,282692,-25955
83,Yercaud,K. Manikandan,IND,485,5,490,238924,282692,-25955
83,Yercaud,T. Priya,IND,284,5,289,238924,282692,-25955
83,Yercaud,Santhosam,IND,165,2,167,238924,282692,-25955
83,Yercaud,S.T. Rajendhiran,IND,158,7,165,238924,282692,-25955
83,Yercaud,P. SATHISHKUMAR,IND,148,0,148,238924,282692,-25955
83,Yercaud,K. UNNAMALAI,IND,109,1,110,238924,282692,-25955
84,Omalur,R.MANI,AIADMK,141527,961,142488,249027,294760,-55294
84,Omalur,RANGARAJAN MOHAN KUMARAMANGALAM,INC,85826,1368,87194,249027,294760,-55294
84,Omalur,A.RAJA,NTK,9341,75,9416,249027,294760,-55294
84,Omalur,V.SRINIVASAN,MNM,2888,42,2930,249027,294760,-55294
84,Omalur,NOTA,NOTA,1581,19,1600,249027,294760,-55294
84,Omalur,M.KARUNAKARAN,Tamil Nadu Ilangyar Katchi,1204,24,1228,249027,294760,-55294
84,Omalur,K.K.MADHESWARAN,AMMK,1188,14,1202,249027,294760,-55294
84,Omalur,N.V.THOMAS,BSP,804,8,812,249027,294760,-55294
84,Omalur,R.MURUGAN,IND,676,0,676,249027,294760,-55294
84,Omalur,P.RAJA,IND,433,1,434,249027,294760,-55294
84,Omalur,R.MANI,IND,282,2,284,249027,294760,-55294
84,Omalur,S.DHIVYA,Dhesiya Makkal Kazhagam,277,4,281,249027,294760,-55294
84,Omalur,S.MANI,IND,144,5,149,249027,294760,-55294
84,Omalur,K.GOVINDARAJU,IND,116,2,118,249027,294760,-55294
84,Omalur,E.MANI,IND,104,7,111,249027,294760,-55294
84,Omalur,T.SURESH,IND,104,0,104,249027,294760,-55294
85,Mettur,SADHASIVAM.S,PMK,95795,1260,97055,218442,285780,-656
85,Mettur,SRINIVASAPERUMAL.S,DMK,94437,1962,96399,218442,285780,-656
85,Mettur,MANIKANDAN.C,NTK,9004,105,9109,218442,285780,-656
85,Mettur,ANUSUYA.P,MNM,4549,56,4605,218442,285780,-656
85,Mettur,SELVAN,IND,2817,6,2823,218442,285780,-656
85,Mettur,NOTA,NOTA,2239,8,2247,218442,285780,-656
85,Mettur,RAMESH ARAVIND.M,DMDK,1860,14,1874,218442,285780,-656
85,Mettur,THANGAVEL. K,Dhesiya Makkal Kazhagam,1781,2,1783,218442,285780,-656
85,Mettur,AMBIKA.A,IND,732,6,738,218442,285780,-656
85,Mettur,BANUPRIYA.P,Ganasangam Party of India,434,1,435,218442,285780,-656
85,Mettur,SADHASIVAM.P,IND,383,3,386,218442,285780,-656
85,Mettur,Dr.PADMARAJAN.K,IND,321,4,325,218442,285780,-656
85,Mettur,SEKAR.P,IND,266,3,269,218442,285780,-656
85,Mettur,RASAPPAN.K,My India Party,226,0,226,218442,285780,-656
85,Mettur,ARIVAZHAGAN.P,IND,166,2,168,218442,285780,-656
86,Edappadi,EDAPPADI PALANISWAMI. K,AIADMK,160931,2223,163154,247301,284394,-93802
86,Edappadi,SAMBATHKUMAR. T,DMK,68082,1270,69352,247301,284394,-93802
86,Edappadi,SHRI RATHNA,NTK,6574,52,6626,247301,284394,-93802
86,Edappadi,THASAPPARAJ. D,MNM,1532,15,1547,247301,284394,-93802
86,Edappadi,NOTA,NOTA,1091,18,1109,247301,284394,-93802
86,Edappadi,JAMUNA. A,BSP,813,2,815,247301,284394,-93802
86,Edappadi,POOKADAI SEKAR. N,AMMK,764,10,774,247301,284394,-93802
86,Edappadi,KATHIRAVAN. V,IND,555,0,555,247301,284394,-93802
86,Edappadi,IYYAPPAN. P,IND,483,0,483,247301,284394,-93802
86,Edappadi,GUHESHKUMAR. M,IND,474,0,474,247301,284394,-93802
86,Edappadi,KATHIRESAN. L,IND,407,0,407,247301,284394,-93802
86,Edappadi,AGNI SRI RAMACHANDRAN. N,IND,259,2,261,247301,284394,-93802
86,Edappadi,LOGANATHAN. S,IND,208,0,208,247301,284394,-93802
86,Edappadi,STALIN. A,IND,202,0,202,247301,284394,-93802
86,Edappadi,LAKSHMI. G,IND,199,0,199,247301,284394,-93802
86,Edappadi,ESWARAMOORTHY P,IND,165,1,166,247301,284394,-93802
86,Edappadi,MANIKANDAN. R,Tamil Nadu Ilangyar Katchi,147,6,153,247301,284394,-93802
86,Edappadi,SOCIAL WORKER ESWARI. P,Ambedkarite Party of India,132,3,135,247301,284394,-93802
86,Edappadi,GUNASEKARAN. K.N,My India Party,117,1,118,247301,284394,-93802
86,Edappadi,MURUGAN. M,IND,90,1,91,247301,284394,-93802
86,Edappadi,ESWARAMURTHY. N,IND,89,0,89,247301,284394,-93802
86,Edappadi,SHANMUGAM. G,IND,66,0,66,247301,284394,-93802
86,Edappadi,SURIYAMOORTHY. S,MGR Makkal Katchi,64,0,64,247301,284394,-93802
86,Edappadi,BALASUBRAMANIAM. J,IND,60,1,61,247301,284394,-93802
86,Edappadi,MANI. C,Dhesiya Makkal Kazhagam,46,1,47,247301,284394,-93802
86,Edappadi,SOWNTHARARAJAN. G,IND,44,0,44,247301,284394,-93802
86,Edappadi,BALAMURUGAN. M,IND,39,0,39,247301,284394,-93802
86,Edappadi,DR. PADMARAJAN. K,IND,35,1,36,247301,284394,-93802
86,Edappadi,PALANISAMY. A,IND,26,0,26,247301,284394,-93802
87,Sankari,"SUNDARARAJAN, S.",AIADMK,114376,1096,115472,232247,271435,-20045
87,Sankari,"RAJESH, K.M.",DMK,93897,1530,95427,232247,271435,-20045
87,Sankari,"SHOBANA, S.",NTK,10788,74,10862,232247,271435,-20045
87,Sankari,"SENGODAN, K.",MNM,3140,35,3175,232247,271435,-20045
87,Sankari,"CHELLAMUTHU, A.",AMMK,1462,9,1471,232247,271435,-20045
87,Sankari,NOTA,NOTA,1453,16,1469,232247,271435,-20045
87,Sankari,"BAKKIYAMANI, M.",IND,846,1,847,232247,271435,-20045
87,Sankari,"SIVALINGAM, C.",Tamilaga Makkal Thannurimai Katchi,812,2,814,232247,271435,-20045
87,Sankari,"PALANIYAPPAN, M.",IND,524,1,525,232247,271435,-20045
87,Sankari,"PRABHU, K.",IND,481,0,481,232247,271435,-20045
87,Sankari,"MANIVEL, P.",IND,276,2,278,232247,271435,-20045
87,Sankari,"DURAIRAJ, C.",IND,209,2,211,232247,271435,-20045
87,Sankari,"RAVIKUMAR, P.",Ganasangam Party of India,197,3,200,232247,271435,-20045
87,Sankari,"GOPALAKRISHNAN, S.",IND,166,0,166,232247,271435,-20045
87,Sankari,"AROKIASAMI, A.",IND,135,0,135,232247,271435,-20045
87,Sankari,"JAGANNATHAN, M.",IND,119,0,119,232247,271435,-20045
87,Sankari,"JAGANATHAN, I.",IND,99,0,99,232247,271435,-20045
87,Sankari,"SENGOTEN, R.",IND,97,0,97,232247,271435,-20045
87,Sankari,"SETTU, K.",My India Party,96,0,96,232247,271435,-20045
87,Sankari,"GUNASEKARAN, M.",IND,92,3,95,232247,271435,-20045
87,Sankari,"SATHISHKUMAR, V.",IND,87,2,89,232247,271435,-20045
87,Sankari,"VIJAYAKUMAR, P.",IND,55,0,55,232247,271435,-20045
87,Sankari,"VENGADACHALAM, T.",IND,33,0,33,232247,271435,-20045
87,Sankari,"VIJI @ VIJAYAN, K.",IND,30,1,31,232247,271435,-20045
88,Salem (West),ARUL. R,PMK,104728,755,105483,216628,298039,-21499
88,Salem (West),RAJENDRAN. A,DMK,82389,1595,83984,216628,298039,-21499
88,Salem (West),NAGAMMAL. S,NTK,10592,76,10668,216628,298039,-21499
88,Salem (West),THIYAGARAJAN. A,MNM,7867,72,7939,216628,298039,-21499
88,Salem (West),ALAGAAPURAM R. MOHANRAJ,DMDK,2280,27,2307,216628,298039,-21499
88,Salem (West),NOTA,NOTA,1663,20,1683,216628,298039,-21499
88,Salem (West),VIJAYAKUMAR. R,Dhesiya Makkal Kazhagam,637,2,639,216628,298039,-21499
88,Salem (West),KARTHIKEYAN. J,Tamil Nadu Ilangyar Katchi,576,4,580,216628,298039,-21499
88,Salem (West),KATHIRVEL. A,My India Party,329,1,330,216628,298039,-21499
88,Salem (West),THIYAGARAJAN. M,IND,315,0,315,216628,298039,-21499
88,Salem (West),TAMIL SELVAN. S,BSP,277,6,283,216628,298039,-21499
88,Salem (West),SARATHKUMAR. S,IND,240,1,241,216628,298039,-21499
88,Salem (West),KATHAVARAYAN. S,IND,230,2,232,216628,298039,-21499
88,Salem (West),SIVARAMAN. S,IND,221,1,222,216628,298039,-21499
88,Salem (West),GOPI. M,IND,211,0,211,216628,298039,-21499
88,Salem (West),CHANDRASEKARAN. G,IND,191,0,191,216628,298039,-21499
88,Salem (West),MUTHUSAMY. R,Tamilaga Makkal Thannurimai Katchi,156,8,164,216628,298039,-21499
88,Salem (West),RAJENDIRAN. B,IND,132,0,132,216628,298039,-21499
88,Salem (West),JEEVANANTHAM. M,IND,128,1,129,216628,298039,-21499
88,Salem (West),RAMKUMAR. R,IND,128,0,128,216628,298039,-21499
88,Salem (West),MARIMUTHU. M,IND,120,0,120,216628,298039,-21499
88,Salem (West),INBARAJ. A,IND,108,2,110,216628,298039,-21499
88,Salem (West),NATARAJAN. C,IND,105,0,105,216628,298039,-21499
88,Salem (West),SENTHILKUMAR. A,Anaithu Makkal Puratchi Katchi,97,2,99,216628,298039,-21499
88,Salem (West),SABBAPATHI. M,IND,93,0,93,216628,298039,-21499
88,Salem (West),MURUGAN. A,IND,78,1,79,216628,298039,-21499
88,Salem (West),GOPINATH. R,IND,68,0,68,216628,298039,-21499
88,Salem (West),MAYAKANNAN. M,IND,57,0,57,216628,298039,-21499
88,Salem (West),BALAJI. D,IND,36,0,36,216628,298039,-21499
89,Salem (North),R. RAJENDRAN,DMK,91222,2210,93432,202376,274801,7588
89,Salem (North),G.VENKATACHALAM,AIADMK,85026,818,85844,202376,274801,7588
89,Salem (North),R S GURU CHAKRAVARTHY,MNM,10610,108,10718,202376,274801,7588
89,Salem (North),IMAYAESWARAN N,NTK,8079,76,8155,202376,274801,7588
89,Salem (North),NOTA,NOTA,1505,34,1539,202376,274801,7588
89,Salem (North),C NATARAJAN,AMMK,800,5,805,202376,274801,7588
89,Salem (North),M.P.PANNEER SELVAM,National People's Party,338,7,345,202376,274801,7588
89,Salem (North),S VELAN,BSP,299,1,300,202376,274801,7588
89,Salem (North),A RAMESHKUMAR,IND,213,0,213,202376,274801,7588
89,Salem (North),R PALANISAMY,IND,208,0,208,202376,274801,7588
89,Salem (North),S RAJASEKAR,IND,177,0,177,202376,274801,7588
89,Salem (North),N DEVARAJ,IND,165,2,167,202376,274801,7588
89,Salem (North),M AHAMEDSHAHJAHAN,MGR Makkal Katchi,95,1,96,202376,274801,7588
89,Salem (North),M.SHANMUGA SUNDARAM,IND,69,4,73,202376,274801,7588
89,Salem (North),R SENTHILKUMAR,IND,62,1,63,202376,274801,7588
89,Salem (North),VAATHIAR C MURUGAN,Ambedkarite Party of India,54,1,55,202376,274801,7588
89,Salem (North),M.R.NAWAZUDIEEN,IND,50,0,50,202376,274801,7588
89,Salem (North),T.VIJAYA RAJ,IND,44,1,45,202376,274801,7588
89,Salem (North),S. BABU,My India Party,39,0,39,202376,274801,7588
89,Salem (North),P.RAMACHANDRAN,IND,27,0,27,202376,274801,7588
89,Salem (North),D.MURALI,Dhesiya Makkal Kazhagam,24,1,25,202376,274801,7588
90,Salem (South),E.BALASUBRAMANIAN,AIADMK,96787,719,97506,199982,259271,-22609
90,Salem (South),A.S.SARAVANAN,DMK,73694,1203,74897,199982,259271,-22609
90,Salem (South),M.PRABU MANIKANDAN,MNM,10308,60,10368,199982,259271,-22609
90,Salem (South),S.MARIAMMA,NTK,10128,48,10176,199982,259271,-22609
90,Salem (South),SE.VENKATAJALAM,AMMK,2952,18,2970,199982,259271,-22609
90,Salem (South),NOTA,NOTA,1832,28,1860,199982,259271,-22609
90,Salem (South),S.MURALI,BSP,397,3,400,199982,259271,-22609
90,Salem (South),R.SUNDARAM,IND,311,0,311,199982,259271,-22609
90,Salem (South),B.DEVI,IND,224,0,224,199982,259271,-22609
90,Salem (South),K.SELVARAJ,IND,210,0,210,199982,259271,-22609
90,Salem (South),SAMUNDESWARI.V,IND,148,1,149,199982,259271,-22609
90,Salem (South),R.VELMURUGAN,CPI(ML)(L),130,3,133,199982,259271,-22609
90,Salem (South),K.N.VEERASENAN,IND,111,1,112,199982,259271,-22609
90,Salem (South),M.SUNDAR,Ambedkarite Party of India,86,1,87,199982,259271,-22609
90,Salem (South),SATHIYAPRIYA,Republican Party of India (Athawale),78,1,79,199982,259271,-22609
90,Salem (South),R.ELAVARASAN,Veerath Thiyagi Viswanathadoss Thozhilalarkal Katchi,74,1,75,199982,259271,-22609
90,Salem (South),S.SARAVANAN,IND,61,2,63,199982,259271,-22609
90,Salem (South),M.KUMAR,IND,61,1,62,199982,259271,-22609
90,Salem (South),M.PERIYASAMY,IND,61,0,61,199982,259271,-22609
90,Salem (South),S.RAJI,Dhesiya Makkal Kazhagam,60,1,61,199982,259271,-22609
90,Salem (South),N.MAYAKANNAN,IND,58,0,58,199982,259271,-22609
90,Salem (South),S.KRISHNAKUMAR,IND,45,1,46,199982,259271,-22609
90,Salem (South),D.M.MOHAMMAD NAZEERUDEEN,IND,25,1,26,199982,259271,-22609
90,Salem (South),K.YASIN BASHA,IND,26,0,26,199982,259271,-22609
90,Salem (South),K.MARIAPPAN,IND,22,0,22,199982,259271,-22609
91,Veerapandi,"RAJAMUTHU, M.",AIADMK,111081,601,111682,223702,259462,-19895
91,Veerapandi,"THARUN, A.K.",DMK,90732,1055,91787,223702,259462,-19895
91,Veerapandi,"RAJESHKUMAR, S.",NTK,9734,72,9806,223702,259462,-19895
91,Veerapandi,"SELVAM, S.K.",AMMK,4957,29,4986,223702,259462,-19895
91,Veerapandi,NOTA,NOTA,1391,18,1409,223702,259462,-19895
91,Veerapandi,"AMUTHA, R.",Indiya Jananayaka Katchi,1293,9,1302,223702,259462,-19895
91,Veerapandi,"MOHAN, V.",IND,384,2,386,223702,259462,-19895
91,Veerapandi,"CHINNANANN, M.",BSP,358,3,361,223702,259462,-19895
91,Veerapandi,"VENKAT, A.",IND,324,0,324,223702,259462,-19895
91,Veerapandi,"SENTHILMURUGAN, E.",IND,265,0,265,223702,259462,-19895
91,Veerapandi,"RAJARATHINAM, K.",IND,236,1,237,223702,259462,-19895
91,Veerapandi,INDRAJITH GUPTHA,IND,229,1,230,223702,259462,-19895
91,Veerapandi,"SEKAR, M.",IND,208,0,208,223702,259462,-19895
91,Veerapandi,"MANI, M.",My India Party,133,0,133,223702,259462,-19895
91,Veerapandi,"MOHAN, P.",SOCIALIST UNITY CENTRE OF INDIA (COMMUNIST),126,3,129,223702,259462,-19895
91,Veerapandi,SATHIYAVANI,Dhesiya Makkal Kazhagam,117,1,118,223702,259462,-19895
91,Veerapandi,"SENTHILKUMAR, J.",IND,94,0,94,223702,259462,-19895
91,Veerapandi,"PRABAKARAN, P.",Veerath Thiyagi Viswanathadoss Thozhilalarkal Katchi,67,2,69,223702,259462,-19895
91,Veerapandi,"VAITHI, M.",IND,62,0,62,223702,259462,-19895
91,Veerapandi,"MANIKANDAN, S.",All India Jananayaka Makkal Kazhagam,59,0,59,223702,259462,-19895
91,Veerapandi,"RAMESH, C.",IND,55,0,55,223702,259462,-19895
92,Rasipuram,MATHIVENTHAN M,DMK,88612,2115,90727,196904,236104,1952
92,Rasipuram,SAROJA V. Dr,AIADMK,87851,924,88775,196904,236104,1952
92,Rasipuram,SILAMBARASI K,NTK,11140,155,11295,196904,236104,1952
92,Rasipuram,NOTA,NOTA,2088,22,2110,196904,236104,1952
92,Rasipuram,RAMKUMAR R,Indiya Jananayaka Katchi,1119,14,1133,196904,236104,1952
92,Rasipuram,ANBALAGAN S,AMMK,1042,9,1051,196904,236104,1952
92,Rasipuram,MUNIYAPPAN M,IND,449,1,450,196904,236104,1952
92,Rasipuram,VIJAYA K,BSP,346,5,351,196904,236104,1952
92,Rasipuram,ARULMOZHIDEVAN P,Tamilaga Makkal Thannurimai Katchi,216,1,217,196904,236104,1952
92,Rasipuram,PALANIVEL S,IND,150,1,151,196904,236104,1952
92,Rasipuram,CHINNUSAMY P,Ganasangam Party of India,146,1,147,196904,236104,1952
92,Rasipuram,JAYANTHI M,Ambedkarite Party of India,140,2,142,196904,236104,1952
92,Rasipuram,MADHIYAZHAGAN D,IND,123,0,123,196904,236104,1952
92,Rasipuram,POONGODI S,IND,88,0,88,196904,236104,1952
92,Rasipuram,MANIVANNAN A,IND,81,0,81,196904,236104,1952
92,Rasipuram,SEERANGAN P,IND,62,1,63,196904,236104,1952
93,Senthamangalam,PONNUSAMY K,DMK,89146,1535,90681,199235,242594,10493
93,Senthamangalam,CHANDRAN S,AIADMK,79703,485,80188,199235,242594,10493
93,Senthamangalam,ROHINI T,NTK,11534,120,11654,199235,242594,10493
93,Senthamangalam,CHANDRASEKARAN C,IND,11328,43,11371,199235,242594,10493
93,Senthamangalam,NOTA,NOTA,2044,14,2058,199235,242594,10493
93,Senthamangalam,CHANDRAN P,AMMK,827,4,831,199235,242594,10493
93,Senthamangalam,RAMASAMY K.V,IND,672,0,672,199235,242594,10493
93,Senthamangalam,SELVARAJ V,Indiya Jananayaka Katchi,428,3,431,199235,242594,10493
93,Senthamangalam,RAMESH R,IND,250,1,251,199235,242594,10493
93,Senthamangalam,MUTHUSAMY C,IND,227,0,227,199235,242594,10493
93,Senthamangalam,THIYAGARAJAN C,IND,202,0,202,199235,242594,10493
93,Senthamangalam,SANKAR P,IND,194,1,195,199235,242594,10493
93,Senthamangalam,RANCHITH C,IND,136,1,137,199235,242594,10493
93,Senthamangalam,DURAIRAJ S,IND,131,0,131,199235,242594,10493
93,Senthamangalam,PRASATH S,IND,116,3,119,199235,242594,10493
93,Senthamangalam,DINESH C,IND,87,0,87,199235,242594,10493
94,Namakkal,RAMALINGAM P,DMK,103480,3014,106494,206759,257065,27861
94,Namakkal,BASKAR K.P.P.,AIADMK,77043,1590,78633,206759,257065,27861
94,Namakkal,BASKAR B,NTK,10008,114,10122,206759,257065,27861
94,Namakkal,ADHAM FAROOK S,MNM,5530,59,5589,206759,257065,27861
94,Namakkal,NOTA,NOTA,1266,19,1285,206759,257065,27861
94,Namakkal,SELVI K,DMDK,960,12,972,206759,257065,27861
94,Namakkal,TAMIZHVANAN K,Tamilaga Makkal Thannurimai Katchi,428,5,433,206759,257065,27861
94,Namakkal,RAMESH T,Ahimsa Socialist Party,307,6,313,206759,257065,27861
94,Namakkal,ARUL SELVAN,IND,287,4,291,206759,257065,27861
94,Namakkal,RAMASAMY P,BSP,254,7,261,206759,257065,27861
94,Namakkal,CHO V,IND,252,1,253,206759,257065,27861
94,Namakkal,DEEPAN CHAKKRAVARTHI S,IND,247,2,249,206759,257065,27861
94,Namakkal,ANBUMANI,IND,220,3,223,206759,257065,27861
94,Namakkal,SELVAKUMAR R,IND,197,1,198,206759,257065,27861
94,Namakkal,THIYAGARAJAN R,Samaniya Makkal Nala Katchi,189,4,193,206759,257065,27861
94,Namakkal,KANAKARAJ K,Ganasangam Party of India,169,6,175,206759,257065,27861
94,Namakkal,SELVAKUMAR E,Manitha Urimaigal Kalaagam,144,5,149,206759,257065,27861
94,Namakkal,SARAVANAN A,National People's Party,130,2,132,206759,257065,27861
94,Namakkal,RAMALINGAM K,IND,114,4,118,206759,257065,27861
94,Namakkal,MADHESWARAN A.S,My India Party,113,1,114,206759,257065,27861
94,Namakkal,SURESH KUMAR L,IND,104,3,107,206759,257065,27861
94,Namakkal,JAYARAMACHANDRAN P,IND,100,1,101,206759,257065,27861
94,Namakkal,MUTHUSAMY S,IND,84,3,87,206759,257065,27861
94,Namakkal,JAWAHAR,IND,85,1,86,206759,257065,27861
94,Namakkal,SIVAKUMAR D,Anna Puratchi Thalaivar Amma Dravida Munnetra Kazhagam,76,2,78,206759,257065,27861
94,Namakkal,SARAVANAN S,Naadaalum Makkal Katchi,57,1,58,206759,257065,27861
94,Namakkal,KUPPUSAMY M,IND,43,2,45,206759,257065,27861
95,Paramathi-Velur,SEKAR S,AIADMK,84593,1441,86034,183697,220994,-7662
95,Paramathi-Velur,MOORTHIY K S,DMK,76062,2310,78372,183697,220994,-7662
95,Paramathi-Velur,UVARANI K,NTK,11554,130,11684,183697,220994,-7662
95,Paramathi-Velur,NATARAJAN K,MNM,1858,24,1882,183697,220994,-7662
95,Paramathi-Velur,SAMINATHAN P P,AMMK,1321,8,1329,183697,220994,-7662
95,Paramathi-Velur,NOTA,NOTA,952,12,964,183697,220994,-7662
95,Paramathi-Velur,RAMAN V,BSP,495,0,495,183697,220994,-7662
95,Paramathi-Velur,SEKAR R,IND,367,1,368,183697,220994,-7662
95,Paramathi-Velur,SUNDARAM N,IND,280,0,280,183697,220994,-7662
95,Paramathi-Velur,SEKAR N,IND,269,1,270,183697,220994,-7662
95,Paramathi-Velur,DEVANDRAN G,IND,259,0,259,183697,220994,-7662
95,Paramathi-Velur,PAPATHI R,IND,232,0,232,183697,220994,-7662
95,Paramathi-Velur,NALLAPPAN K,IND,219,0,219,183697,220994,-7662
95,Paramathi-Velur,THANGARASU M,IND,177,1,178,183697,220994,-7662
95,Paramathi-Velur,SEERANGAN P,IND,155,1,156,183697,220994,-7662
95,Paramathi-Velur,SUNDARAM S,United States of India Party,132,4,136,183697,220994,-7662
95,Paramathi-Velur,MANI K,Ganasangam Party of India,128,4,132,183697,220994,-7662
95,Paramathi-Velur,JAYAKUMAR K,IND,112,0,112,183697,220994,-7662
95,Paramathi-Velur,PARTHASARATHY S,IND,88,0,88,183697,220994,-7662
95,Paramathi-Velur,MOORTHY M,IND,86,1,87,183697,220994,-7662
95,Paramathi-Velur,KARTHIKEYAN N,IND,69,1,70,183697,220994,-7662
95,Paramathi-Velur,SAMYNATHAN G,IND,67,1,68,183697,220994,-7662
95,Paramathi-Velur,SATHISKUMAR D,IND,66,1,67,183697,220994,-7662
95,Paramathi-Velur,KUZHANDAIVEL K,IND,65,0,65,183697,220994,-7662
95,Paramathi-Velur,PERIASAMY R,IND,52,0,52,183697,220994,-7662
95,Paramathi-Velur,PRABHAHARAN M,IND,41,1,42,183697,220994,-7662
95,Paramathi-Velur,BALAJI R,IND,33,2,35,183697,220994,-7662
95,Paramathi-Velur,BALASUBRAMANIAN A,IND,21,0,21,183697,220994,-7662
96,Tiruchengodu,ESWARAN E R,DMK,79934,1754,81688,184669,230320,2862
96,Tiruchengodu,SARASWATHI PON,AIADMK,78010,816,78826,184669,230320,2862
96,Tiruchengodu,NATARAJAN P,NTK,13857,110,13967,184669,230320,2862
96,Tiruchengodu,JANAGARAJ R,MNM,3695,29,3724,184669,230320,2862
96,Tiruchengodu,NOTA,NOTA,1506,12,1518,184669,230320,2862
96,Tiruchengodu,SHANMUGASUNDARAM T,IND,665,1,666,184669,230320,2862
96,Tiruchengodu,KALAIVANAN A,My India Party,510,5,515,184669,230320,2862
96,Tiruchengodu,HEMALATHA R,AMMK,446,3,449,184669,230320,2862
96,Tiruchengodu,SATHIESHKUMAR C,IND,391,0,391,184669,230320,2862
96,Tiruchengodu,BALAMURUGAN C,IND,378,1,379,184669,230320,2862
96,Tiruchengodu,KARTHIKEYAN S,IND,373,2,375,184669,230320,2862
96,Tiruchengodu,SENGOTTUVELLU N,Ahimsa Socialist Party,353,5,358,184669,230320,2862
96,Tiruchengodu,ESWARAN M,IND,325,1,326,184669,230320,2862
96,Tiruchengodu,CHANDRA R,IND,210,0,210,184669,230320,2862
96,Tiruchengodu,SIVAKUMAR K,Tamilaga Makkal Thannurimai Katchi,203,1,204,184669,230320,2862
96,Tiruchengodu,SELVARAMLINGAM,IND,196,4,200,184669,230320,2862
96,Tiruchengodu,VELU K,IND,126,1,127,184669,230320,2862
96,Tiruchengodu,YUVARAJKUMAR K,Namathu Kongu Munnetra Kalagam,100,0,100,184669,230320,2862
96,Tiruchengodu,RANJIT R,IND,93,3,96,184669,230320,2862
96,Tiruchengodu,SARASWATHI M,IND,71,5,76,184669,230320,2862
96,Tiruchengodu,CHINNATHAMBI K,Republican Party of India (Athawale),75,0,75,184669,230320,2862
96,Tiruchengodu,SELVARAJ K R,IND,62,0,62,184669,230320,2862
96,Tiruchengodu,ESWARAN K,IND,57,4,61,184669,230320,2862
96,Tiruchengodu,BALAJICHEZHIAN P,IND,54,0,54,184669,230320,2862
96,Tiruchengodu,BALAMURUGAN S,IND,52,1,53,184669,230320,2862
96,Tiruchengodu,ESWARAN A,IND,52,0,52,184669,230320,2862
96,Tiruchengodu,ESWARAN G,IND,48,1,49,184669,230320,2862
96,Tiruchengodu,SARAVANAN K,IND,43,0,43,184669,230320,2862
96,Tiruchengodu,SENTHILKUMAR C,IND,24,1,25,184669,230320,2862
97,Kumarapalayam,THANGAMANI.P,AIADMK,100201,599,100800,201925,254251,-31646
97,Kumarapalayam,M.VENKATACHALAM,DMK,68521,633,69154,201925,254251,-31646
97,Kumarapalayam,S.VARUN,NTK,13171,69,13240,201925,254251,-31646
97,Kumarapalayam,OMMSHARRAVANA.S,IND,7305,37,7342,201925,254251,-31646
97,Kumarapalayam,K.KAMARAJ,MNM,6107,18,6125,201925,254251,-31646
97,Kumarapalayam,NOTA,NOTA,1337,5,1342,201925,254251,-31646
97,Kumarapalayam,K.R.SIVASUBIRAMANIYAN,DMDK,1021,1,1022,201925,254251,-31646
97,Kumarapalayam,P.SENGODAGOUNDAR,IND,409,2,411,201925,254251,-31646
97,Kumarapalayam,R.KUMARESAN,Manitha Urimaigal Kalaagam,304,0,304,201925,254251,-31646
97,Kumarapalayam,M.DHANASEKARAN,IND,252,0,252,201925,254251,-31646
97,Kumarapalayam,SARAVANAN,IND,242,0,242,201925,254251,-31646
97,Kumarapalayam,GOWRISANKARAN,IND,199,1,200,201925,254251,-31646
97,Kumarapalayam,S.PONGIYANNAN,IND,193,1,194,201925,254251,-31646
97,Kumarapalayam,B.BALAKRISHNAN,IND,188,0,188,201925,254251,-31646
97,Kumarapalayam,KARTHI,IND,155,0,155,201925,254251,-31646
97,Kumarapalayam,K.SELLAPPAN,IND,131,0,131,201925,254251,-31646
97,Kumarapalayam,V.AMIRTHALINGAM,IND,118,1,119,201925,254251,-31646
97,Kumarapalayam,SUBRAMANI.S,CPI(ML)(L),112,1,113,201925,254251,-31646
97,Kumarapalayam,P.VENKATACHALAM,IND,100,1,101,201925,254251,-31646
97,Kumarapalayam,K.VENKATACHALAM,IND,77,1,78,201925,254251,-31646
97,Kumarapalayam,M.KATHAVARAYAN,IND,76,0,76,201925,254251,-31646
97,Kumarapalayam,GOPALAKRISHNAN,IND,61,2,63,201925,254251,-31646
97,Kumarapalayam,R.KUMAR,Ambedkarite Party of India,55,2,57,201925,254251,-31646
97,Kumarapalayam,G.RAJUGANESAN,IND,42,0,42,201925,254251,-31646
97,Kumarapalayam,S.PRABHAKARAN,IND,37,0,37,201925,254251,-31646
97,Kumarapalayam,K.A.VIJAYAN,IND,35,0,35,201925,254251,-31646
97,Kumarapalayam,M.YUVARAJ,IND,30,0,30,201925,254251,-31646
97,Kumarapalayam,A.VENKATACHALAM,IND,27,0,27,201925,254251,-31646
97,Kumarapalayam,G.RAGAVENDIRAN,IND,23,0,23,201925,254251,-31646
97,Kumarapalayam,MANIKANDAN,IND,22,0,22,201925,254251,-31646
98,Erode (East),"THIRUMAHAN EVERAA,E.",INC,66497,803,67300,152037,226942,8904
98,Erode (East),"YUVARAJA,M.",AIADMK,58097,299,58396,152037,226942,8904
98,Erode (East),"GOMATHI,S.",NTK,11575,54,11629,152037,226942,8904
98,Erode (East),"RAJAKUMAR,A.M.R",MNM,9966,39,10005,152037,226942,8904
98,Erode (East),NOTA,NOTA,1530,16,1546,152037,226942,8904
98,Erode (East),"MUTHUKUMARAN,S.A.",AMMK,1197,7,1204,152037,226942,8904
98,Erode (East),ARUMUGA AC KANNAN,Ambedkarite Party of India,373,0,373,152037,226942,8904
98,Erode (East),"GOVINDARAJ,S.",BSP,366,6,372,152037,226942,8904
98,Erode (East),"MEENAKSHI,V.",IND,296,3,299,152037,226942,8904
98,Erode (East),"SHAJAHAN,I.",IND,256,0,256,152037,226942,8904
98,Erode (East),"YUVARAJ,M.",IND,234,1,235,152037,226942,8904
98,Erode (East),"SHANMUGAVEL,S.",MGR Makkal Katchi,150,1,151,152037,226942,8904
98,Erode (East),"RAJA,P.","Makkal Thilagam Munnetra Kazhagam,",100,2,102,152037,226942,8904
98,Erode (East),"ANTONY PETER,L.",IND,95,1,96,152037,226942,8904
98,Erode (East),"MINNAL MURUGESH,R.",IND,72,1,73,152037,226942,8904
99,Erode (West),Muthusamy S,DMK,99032,1725,100757,205579,291319,22089
99,Erode (West),Ramalingam K V,AIADMK,78200,468,78668,205579,291319,22089
99,Erode (West),Chandra kumar P,NTK,13297,56,13353,205579,291319,22089
99,Erode (West),Durai Sevugan,MNM,8068,39,8107,205579,291319,22089
99,Erode (West),NOTA,NOTA,1954,14,1968,205579,291319,22089
99,Erode (West),Sivasubramaniyan S,AMMK,728,2,730,205579,291319,22089
99,Erode (West),Dhanalakshmi A,BSP,568,0,568,205579,291319,22089
99,Erode (West),Vimala M,IND,432,2,434,205579,291319,22089
99,Erode (West),Muthusamy A,IND,189,0,189,205579,291319,22089
99,Erode (West),VENGATESAN A,IND,177,2,179,205579,291319,22089
99,Erode (West),Kalithass R,IND,166,3,169,205579,291319,22089
99,Erode (West),Chandran M,Ambedkarite Party of India,113,0,113,205579,291319,22089
99,Erode (West),Thangavel G,United States of India Party,106,3,109,205579,291319,22089
99,Erode (West),Madhan K,Ganasangam Party of India,108,0,108,205579,291319,22089
99,Erode (West),Iyyavu R,IND,71,2,73,205579,291319,22089
99,Erode (West),Balasubramaniam K,India Dravida Makkal Munnetra Katchi,54,0,54,205579,291319,22089
100,Modakkurichi,SARASWATHI.C,BJP,77653,472,78125,181857,237465,-281
100,Modakkurichi,SUBBULAKSHMI JEGADEESAN,DMK,76409,1435,77844,181857,237465,-281
100,Modakkurichi,PRAKASH.G,NTK,12871,73,12944,181857,237465,-281
100,Modakkurichi,RAJESHKUMAR.M,MNM,4555,19,4574,181857,237465,-281
100,Modakkurichi,NOTA,NOTA,2332,10,2342,181857,237465,-281
100,Modakkurichi,THANGARAJ.D,AMMK,1539,8,1547,181857,237465,-281
100,Modakkurichi,BOOPATHI.R,BSP,1136,7,1143,181857,237465,-281
100,Modakkurichi,SAMI KANDHASAMY,IND,881,1,882,181857,237465,-281
100,Modakkurichi,VIJAYAKUMAR.M,IND,562,7,569,181857,237465,-281
100,Modakkurichi,MAYILSAMY.P,IND,335,0,335,181857,237465,-281
100,Modakkurichi,MANICKAM.R,Ganasangam Party of India,326,1,327,181857,237465,-281
100,Modakkurichi,GOVANAM THANGAVEL.K.S,IND,300,1,301,181857,237465,-281
100,Modakkurichi,MAHESWARAN .A,My India Party,288,7,295,181857,237465,-281
100,Modakkurichi,BHARATHI.L,IND,273,2,275,181857,237465,-281
100,Modakkurichi,RAMESH.M,Namathu Kongu Munnetra Kalagam,230,5,235,181857,237465,-281
100,Modakkurichi,MANI.P,India Dravida Makkal Munnetra Katchi,119,0,119,181857,237465,-281
101,Dharapuram (SC),KAYALVIZHI N,DMK,88471,1515,89986,193991,257958,1393
101,Dharapuram (SC),MURUGAN L,BJP,87964,629,88593,193991,257958,1393
101,Dharapuram (SC),RANJITHA K,NTK,6691,62,6753,193991,257958,1393
101,Dharapuram (SC),CHARLI A,MNM,2114,16,2130,193991,257958,1393
101,Dharapuram (SC),NOTA,NOTA,1881,22,1903,193991,257958,1393
101,Dharapuram (SC),KALARANI C,AMMK,1166,6,1172,193991,257958,1393
101,Dharapuram (SC),KAYALVIZHI K,IND,887,5,892,193991,257958,1393
101,Dharapuram (SC),MURUGAN A,IND,824,2,826,193991,257958,1393
101,Dharapuram (SC),RANGASAMY S,BSP,638,2,640,193991,257958,1393
101,Dharapuram (SC),SELVARAJ V,IND,233,0,233,193991,257958,1393
101,Dharapuram (SC),MUNIYAPPAN A,Anna Puratchi Thalaivar Amma Dravida Munnetra Kazhagam,220,0,220,193991,257958,1393
101,Dharapuram (SC),KAYALVIZHI P,IND,201,1,202,193991,257958,1393
101,Dharapuram (SC),KARTHIKEYAN A,IND,157,1,158,193991,257958,1393
101,Dharapuram (SC),ANANTHI S,IND,152,5,157,193991,257958,1393
101,Dharapuram (SC),CHIDAMBHARAM V,India Dravida Makkal Munnetra Katchi,123,3,126,193991,257958,1393
102,Kangayam,SAMINATHAN.M.P,DMK,93178,1019,94197,199818,258547,7331
102,Kangayam,RAMALINGAM.A.S,AIADMK,86477,389,86866,199818,258547,7331
102,Kangayam,SIVANANTHAM.K,NTK,11248,59,11307,199818,258547,7331
102,Kangayam,APPASAMY.R,IND,2317,10,2327,199818,258547,7331
102,Kangayam,NOTA,NOTA,1020,7,1027,199818,258547,7331
102,Kangayam,RAMESH.C,AMMK,474,0,474,199818,258547,7331
102,Kangayam,IMMANUVEL.R,IND,434,1,435,199818,258547,7331
102,Kangayam,AYYAVU.N,BSP,421,0,421,199818,258547,7331
102,Kangayam,MANIKANDAN.R,IND,330,0,330,199818,258547,7331
102,Kangayam,NITHIYANDHAN.C,IND,285,0,285,199818,258547,7331
102,Kangayam,NALLAMUTHU.P,IND,276,0,276,199818,258547,7331
102,Kangayam,MANI.A,IND,273,0,273,199818,258547,7331
102,Kangayam,GOPINATH.P,IND,247,0,247,199818,258547,7331
102,Kangayam,SELVAKUMAR.K,IND,225,0,225,199818,258547,7331
102,Kangayam,MANOHARAN.S,Anna Puratchi Thalaivar Amma Dravida Munnetra Kazhagam,134,0,134,199818,258547,7331
102,Kangayam,SUBRAMANIAN.D,IND,123,1,124,199818,258547,7331
102,Kangayam,PRABHAKARAN.G,IND,113,0,113,199818,258547,7331
102,Kangayam,SATHYAMOORTHI.S,IND,106,1,107,199818,258547,7331
102,Kangayam,RAVIKUMAR.R,IND,98,2,100,199818,258547,7331
102,Kangayam,RAJENDRAN.B,IND,94,1,95,199818,258547,7331
102,Kangayam,JAHANGEER.K.O.,IND,88,1,89,199818,258547,7331
102,Kangayam,JOTHI KALIMUTHU.G,IND,84,0,84,199818,258547,7331
102,Kangayam,VADUGANATHAN.K.K.,IND,83,0,83,199818,258547,7331
102,Kangayam,SATHISH KUMAR.P,IND,60,2,62,199818,258547,7331
102,Kangayam,SUKUMARAN.N,IND,59,0,59,199818,258547,7331
102,Kangayam,RAJENDRAN.P,IND,40,0,40,199818,258547,7331
102,Kangayam,RAMALINGAM.N,IND,38,0,38,199818,258547,7331
103,Perundurai,"JAYAKUMAR, S.",AIADMK,84532,593,85125,189843,227420,-14507
103,Perundurai,KKC BALU,DMK,69569,1049,70618,189843,227420,-14507
103,Perundurai,"LOGANATHAN, C.",NTK,10243,51,10294,189843,227420,-14507
103,Perundurai,THOPPU VENKATACHALAM (A) N.D .VENKATACHALAM,IND,9815,80,9895,189843,227420,-14507
103,Perundurai,"NANDHAKUMAR, C. K.",MNM,3506,27,3533,189843,227420,-14507
103,Perundurai,SHANKARSAMY,IND,3328,8,3336,189843,227420,-14507
103,Perundurai,"THAMBI, M.",BSP,1612,8,1620,189843,227420,-14507
103,Perundurai,NOTA,NOTA,1179,10,1189,189843,227420,-14507
103,Perundurai,"KULANDAIVEL, P. R.",DMDK,857,1,858,189843,227420,-14507
103,Perundurai,"SATHISHKUMAR, N.",IND,799,0,799,189843,227420,-14507
103,Perundurai,"DHAKSHINAMURTHI, K. S.",Desiya Makkal Sakthi Katchi,617,1,618,189843,227420,-14507
103,Perundurai,"SAMPATH KUMAR, K.",IND,245,0,245,189843,227420,-14507
103,Perundurai,"VENKADACHALAM, P. R.",IND,219,2,221,189843,227420,-14507
103,Perundurai,"GOPALAKRISHNAN, J.",IND,182,0,182,189843,227420,-14507
103,Perundurai,"DEVENDARAMANICKAM, S. R.",IND,176,4,180,189843,227420,-14507
103,Perundurai,"KARTHI, M.",IND,169,0,169,189843,227420,-14507
103,Perundurai,"BALAMURUGAN, M.",IND,129,0,129,189843,227420,-14507
103,Perundurai,"BALASUBRAMANI, V. M.",IND,128,0,128,189843,227420,-14507
103,Perundurai,"VELUSAMY, P.",Anna Puratchi Thalaivar Amma Dravida Munnetra Kazhagam,107,0,107,189843,227420,-14507
103,Perundurai,"JOTHIMURUGAN, P.",IND,106,0,106,189843,227420,-14507
103,Perundurai,"PRABAKARAN, D.",All India Jananayaka Makkal Kazhagam,102,0,102,189843,227420,-14507
103,Perundurai,"RAMESH, M.",Namathu Kongu Munnetra Kalagam,89,1,90,189843,227420,-14507
103,Perundurai,"MYILSAMY, M.",IND,85,1,86,189843,227420,-14507
103,Perundurai,"KRISHNAN, S.",IND,79,0,79,189843,227420,-14507
103,Perundurai,"JEEVA, N.",IND,74,0,74,189843,227420,-14507
103,Perundurai,"VENKATACHALAM, K.",IND,59,1,60,189843,227420,-14507
104,Bhavani,KARUPPANAN.K.C,AIADMK,100285,630,100915,201385,240533,-22523
104,Bhavani,DURAIRAJ.K.P,DMK,77079,1313,78392,201385,240533,-22523
104,Bhavani,SATHYA.M,NTK,10410,61,10471,201385,240533,-22523
104,Bhavani,SADHANANDHAM.K,MNM,4186,35,4221,201385,240533,-22523
104,Bhavani,NOTA,NOTA,2070,9,2079,201385,240533,-22523
104,Bhavani,SATHEESH KUMAR.P,IND,1221,3,1224,201385,240533,-22523
104,Bhavani,RADHAKRISHNAN.M,AMMK,953,3,956,201385,240533,-22523
104,Bhavani,AMMASAI.K,Kongu  Desa  Marumalarchi  Makkal  Katchi,936,7,943,201385,240533,-22523
104,Bhavani,GOPAL.M,BSP,868,2,870,201385,240533,-22523
104,Bhavani,PERUMAL.V.M,IND,419,0,419,201385,240533,-22523
104,Bhavani,JANARTHANAM.R.P,Tamilaga Makkal Thannurimai Katchi,320,2,322,201385,240533,-22523
104,Bhavani,STANLEY.G,IND,244,1,245,201385,240533,-22523
104,Bhavani,KARTHIKEYAN.P,IND,121,1,122,201385,240533,-22523
104,Bhavani,ABDUL KADHER.A,IND,107,0,107,201385,240533,-22523
104,Bhavani,APPICHI.T.K,IND,99,0,99,201385,240533,-22523
105,Anthiyur,VENKATACHALAM.A.G,DMK,78038,1058,79096,176385,218949,1275
105,Anthiyur,SHANMUGAVEL.K.S,AIADMK,77474,347,77821,176385,218949,1275
105,Anthiyur,SARAVANAN.M,NTK,8162,68,8230,176385,218949,1275
105,Anthiyur,GURUNATHAN.M,MNM,2466,8,2474,176385,218949,1275
105,Anthiyur,PRATHABAN.A,Ahimsa Socialist Party,2035,10,2045,176385,218949,1275
105,Anthiyur,SELVAM.S.R,AMMK,1207,5,1212,176385,218949,1275
105,Anthiyur,NOTA,NOTA,1017,10,1027,176385,218949,1275
105,Anthiyur,PATTAN.G,BSP,956,1,957,176385,218949,1275
105,Anthiyur,POORNACHANDRAN.S,IND,567,0,567,176385,218949,1275
105,Anthiyur,THANGAVEL.M,IND,543,0,543,176385,218949,1275
105,Anthiyur,SHANMUGAM.K,IND,503,0,503,176385,218949,1275
105,Anthiyur,MUTHUSAMY.M,IND,428,0,428,176385,218949,1275
105,Anthiyur,RAJENDRAN.K,Ganasangam Party of India,229,0,229,176385,218949,1275
105,Anthiyur,KUMARASAMY.R,IND,224,1,225,176385,218949,1275
105,Anthiyur,ANBALAGAN.K,IND,198,1,199,176385,218949,1275
105,Anthiyur,SENGUTTUVAN.M.R,IND,183,1,184,176385,218949,1275
105,Anthiyur,GEETHA.M,IND,151,1,152,176385,218949,1275
105,Anthiyur,PERIYASAMY.T,IND,146,1,147,176385,218949,1275
105,Anthiyur,KARTHIKEYAN.R,IND,130,2,132,176385,218949,1275
105,Anthiyur,SHEIKDAVOOD.A.M,IND,110,1,111,176385,218949,1275
105,Anthiyur,BAKKIYAM.M,India Dravida Makkal Munnetra Katchi,103,0,103,176385,218949,1275
106,Gobichettipalayam,SENGOTTAIYAN K.A,AIADMK,107571,1037,108608,214281,255504,-28563
106,Gobichettipalayam,MANIMARAN G.V,DMK,78488,1557,80045,214281,255504,-28563
106,Gobichettipalayam,SEETHALAKSHMI M.K,NTK,11661,58,11719,214281,255504,-28563
106,Gobichettipalayam,PRAKASH N.K,MNM,4258,33,4291,214281,255504,-28563
106,Gobichettipalayam,THULASIMANI N.K,AMMK,2653,29,2682,214281,255504,-28563
106,Gobichettipalayam,NOTA,NOTA,1295,12,1307,214281,255504,-28563
106,Gobichettipalayam,PALANISAMY P,BSP,1027,7,1034,214281,255504,-28563
106,Gobichettipalayam,MOHANRAJ K,IND,789,0,789,214281,255504,-28563
106,Gobichettipalayam,RAKKIMUTHU RANGANADAR R,IND,611,0,611,214281,255504,-28563
106,Gobichettipalayam,SRIDEVI R,IND,473,3,476,214281,255504,-28563
106,Gobichettipalayam,PALANISAMYRAAJ M,IND,426,4,430,214281,255504,-28563
106,Gobichettipalayam,BOOPATHIRAJA  A.N,IND,418,0,418,214281,255504,-28563
106,Gobichettipalayam,SAKTHIVEL G,India Dravida Makkal Munnetra Katchi,412,3,415,214281,255504,-28563
106,Gobichettipalayam,DHANABAL K,IND,310,1,311,214281,255504,-28563
106,Gobichettipalayam,DEVARAJ N,IND,305,2,307,214281,255504,-28563
106,Gobichettipalayam,MUTHUMANI P,IND,296,0,296,214281,255504,-28563
106,Gobichettipalayam,JUNAYATH M,IND,178,0,178,214281,255504,-28563
106,Gobichettipalayam,SANKARKUMAR K.A,IND,157,0,157,214281,255504,-28563
106,Gobichettipalayam,KUMAR D,IND,128,2,130,214281,255504,-28563
106,Gobichettipalayam,SELVAKKUMAR S,IND,77,0,77,214281,255504,-28563
107,Bhavanisagar,A.Bannari,AIADMK,98934,247,99181,200567,259126,-16008
107,Bhavanisagar,P.L SUNDARAM,CPI,82200,973,83173,200567,259126,-16008
107,Bhavanisagar,V.SANGEETHA,NTK,8479,38,8517,200567,259126,-16008
107,Bhavanisagar,KARTHIKKUMAR.K,MNM,4280,17,4297,200567,259126,-16008
107,Bhavanisagar,RAMESH.G,DMDK,2193,4,2197,200567,259126,-16008
107,Bhavanisagar,NOTA,NOTA,2003,2,2005,200567,259126,-16008
107,Bhavanisagar,G.SAKTHIVEL,BSP,1194,3,1197,200567,259126,-16008
108,Udhagamandalam,"GANESH, R.",INC,64148,1382,65530,141102,205139,5348
108,Udhagamandalam,"BHOJARAJAN, M.",BJP,59553,629,60182,141102,205139,5348
108,Udhagamandalam,"JAYAKUMAR, A.",NTK,6316,65,6381,141102,205139,5348
108,Udhagamandalam,"Dr.SURESH BABU, S.",MNM,4859,76,4935,141102,205139,5348
108,Udhagamandalam,NOTA,NOTA,1357,19,1376,141102,205139,5348
108,Udhagamandalam,"LAKSHMANAN, T.",AMMK,1250,23,1273,141102,205139,5348
108,Udhagamandalam,"AROKIYANATHAN, B.",IND,514,0,514,141102,205139,5348
108,Udhagamandalam,"VINOTHKUMAR, M.A.",IND,425,6,431,141102,205139,5348
108,Udhagamandalam,"KRISHNAMURTHI, B.",IND,249,6,255,141102,205139,5348
108,Udhagamandalam,"A. SARDAR BABU, B.COM.",IND,223,2,225,141102,205139,5348
109,Gudalur,PON.JAYASEELAN,AIADMK,63810,686,64496,138257,188611,-1945
109,Gudalur,"KASILINGAM, S.",DMK,61564,987,62551,138257,188611,-1945
109,Gudalur,"KETHEESWARAN, R.",NTK,7252,65,7317,138257,188611,-1945
109,Gudalur,"YOGESWARAN, A.",DMDK,1160,13,1173,138257,188611,-1945
109,Gudalur,NOTA,NOTA,1003,14,1017,138257,188611,-1945
109,Gudalur,"BABU, J.",MNM,950,10,960,138257,188611,-1945
109,Gudalur,"SARAVANAN, M.",IND,417,4,421,138257,188611,-1945
109,Gudalur,"JAYAPRAKASH, P.",Tamilaga Makkal Thannurimai Katchi,321,1,322,138257,188611,-1945
110,Coonoor,"Ramachandran, K.",DMK,60471,1349,61820,135908,191325,4105
110,Coonoor,"Vinoth, D.",AIADMK,57254,461,57715,135908,191325,4105
110,Coonoor,"Lavanya, M.",NTK,7182,70,7252,135908,191325,4105
110,Coonoor,"Rajakumar, H.B.",MNM,3587,34,3621,135908,191325,4105
110,Coonoor,"Kalaiselvan, S.",AMMK,2499,28,2527,135908,191325,4105
110,Coonoor,NOTA,NOTA,1177,11,1188,135908,191325,4105
110,Coonoor,"Jayaprakash, D",IND,509,4,513,135908,191325,4105
110,Coonoor,"Arumugam, R.",Anaithu Makkal Puratchi Katchi,435,4,439,135908,191325,4105
110,Coonoor,"Prabhu Inbadass, S.",All India Trinamool Congress,399,5,404,135908,191325,4105
110,Coonoor,"Basha, A.",IND,313,7,320,135908,191325,4105
110,Coonoor,"Chandran, K.",IND,107,2,109,135908,191325,4105
111,Mettuppalayam,SELVARAJ A K,AIADMK,104632,599,105231,225083,294951,-2456
111,Mettuppalayam,SHANMUGASUNDARAM T R,DMK,101451,1324,102775,225083,294951,-2456
111,Mettuppalayam,YASMIN K,NTK,10900,54,10954,225083,294951,-2456
111,Mettuppalayam,NOTA,NOTA,2701,32,2733,225083,294951,-2456
111,Mettuppalayam,SARAVANAN P,AMMK,1856,8,1864,225083,294951,-2456
111,Mettuppalayam,SRINIVASAN S,IND,653,7,660,225083,294951,-2456
111,Mettuppalayam,MAHESHWARAN K,Veerath Thiyagi Viswanathadoss Thozhilalarkal Katchi,274,0,274,225083,294951,-2456
111,Mettuppalayam,SHANMUGASUNDARAM P,IND,184,0,184,225083,294951,-2456
111,Mettuppalayam,LIAKATHALI O,IND,182,1,183,225083,294951,-2456
111,Mettuppalayam,SHANMUGASUNDARAM K,IND,115,0,115,225083,294951,-2456
111,Mettuppalayam,MARIAPPAN T,IND,110,0,110,225083,294951,-2456
112,Avanashi (SC),"DHANAPAL, P",AIADMK,116674,610,117284,212627,280743,-50902
112,Avanashi (SC),ATHIYAMAAN RAJU,DMK,65453,929,66382,212627,280743,-50902
112,Avanashi (SC),SHOBA,NTK,13211,45,13256,212627,280743,-50902
112,Avanashi (SC),"VENKATESWARAN, A",MNM,8318,61,8379,212627,280743,-50902
112,Avanashi (SC),"MEERA, K",DMDK,2554,23,2577,212627,280743,-50902
112,Avanashi (SC),NOTA,NOTA,2352,20,2372,212627,280743,-50902
112,Avanashi (SC),"DURAISAMY, P",BSP,831,2,833,212627,280743,-50902
112,Avanashi (SC),"RANGASAMY, P",IND,520,0,520,212627,280743,-50902
112,Avanashi (SC),"MURUGESAN, R",IND,379,0,379,212627,280743,-50902
112,Avanashi (SC),"SAKUNTHALA, T",IND,178,1,179,212627,280743,-50902
112,Avanashi (SC),"ARUMUGAM, P",IND,171,2,173,212627,280743,-50902
112,Avanashi (SC),ANNAMALAI,IND,150,4,154,212627,280743,-50902
112,Avanashi (SC),"SUBRAMANI, K",India Dravida Makkal Munnetra Katchi,137,2,139,212627,280743,-50902
113,Tiruppur (North),VIJEYAKUMAR.K.N,AIADMK,113119,265,113384,238092,376139,-40102
113,Tiruppur (North),RAVI (Alias) SUBRAMANIAN . M,CPI,72679,603,73282,238092,376139,-40102
113,Tiruppur (North),EASWARAN.S,NTK,23061,49,23110,238092,376139,-40102
113,Tiruppur (North),SIVABALAN.S,MNM,19565,37,19602,238092,376139,-40102
113,Tiruppur (North),SELVAKUMAR.M,DMDK,3420,7,3427,238092,376139,-40102
113,Tiruppur (North),NOTA,NOTA,2154,8,2162,238092,376139,-40102
113,Tiruppur (North),ALAGHUSUNDARAM.P,Anna Dravidar Kazhagam,591,1,592,238092,376139,-40102
113,Tiruppur (North),CHANDRASEKARAN.R,BSP,474,3,477,238092,376139,-40102
113,Tiruppur (North),SENTHILKUMAR.V,Anna Puratchi Thalaivar Amma Dravida Munnetra Kazhagam,426,2,428,238092,376139,-40102
113,Tiruppur (North),RANGASAMY.M,IND,365,1,366,238092,376139,-40102
113,Tiruppur (North),UDHAYAKUMAR.S,IND,337,5,342,238092,376139,-40102
113,Tiruppur (North),SENTHILVEL.A,IND,301,1,302,238092,376139,-40102
113,Tiruppur (North),MURUGA PANDI.S,IND,249,1,250,238092,376139,-40102
113,Tiruppur (North),DEIVASIGAMANI.K,Ezhuchi Tamilargal Munnetra Kazhagam,139,0,139,238092,376139,-40102
113,Tiruppur (North),SENTHILKUMAR.R,IND,131,2,133,238092,376139,-40102
113,Tiruppur (North),SENTHILKUMAR.T.N,IND,96,0,96,238092,376139,-40102
114,Tiruppur (South),SELVARAJ. K.,DMK,74944,591,75535,174418,275564,4709
114,Tiruppur (South),GUNASEKARAN. S.,AIADMK,70551,275,70826,174418,275564,4709
114,Tiruppur (South),SHANMUGASUNDARAM. K.,NTK,12870,28,12898,174418,275564,4709
114,Tiruppur (South),ANUSHA RAVI.,MNM,9914,20,9934,174418,275564,4709
114,Tiruppur (South),VISHALAKCHI. A.,AMMK,1751,6,1757,174418,275564,4709
114,Tiruppur (South),NOTA,NOTA,1133,9,1142,174418,275564,4709
114,Tiruppur (South),ARUNKUMAR. G.,Tamil Nadu Ilangyar Katchi,554,0,554,174418,275564,4709
114,Tiruppur (South),CHELLAPANDY. P.,BSP,311,1,312,174418,275564,4709
114,Tiruppur (South),PRAKASH. R.,IND,264,1,265,174418,275564,4709
114,Tiruppur (South),SELVAN. K.,IND,224,0,224,174418,275564,4709
114,Tiruppur (South),ASLAM. J.,IND,163,1,164,174418,275564,4709
114,Tiruppur (South),SARVALOGA DAYABARAN. M.A.,IND,147,0,147,174418,275564,4709
114,Tiruppur (South),MUTHUSAMY. K.,IND,121,0,121,174418,275564,4709
114,Tiruppur (South),DEIVEEGAN. K.,Anna Puratchi Thalaivar Amma Dravida Munnetra Kazhagam,101,0,101,174418,275564,4709
114,Tiruppur (South),MALARVIZHI. G.,IND,83,0,83,174418,275564,4709
114,Tiruppur (South),GUNASEKARAN. M.,IND,80,0,80,174418,275564,4709
114,Tiruppur (South),KADER BASHA. A.,IND,75,1,76,174418,275564,4709
114,Tiruppur (South),SELVARAJ. A.,IND,68,0,68,174418,275564,4709
114,Tiruppur (South),GANESH. E.,IND,66,0,66,174418,275564,4709
114,Tiruppur (South),GUNASEKARAN. I.,IND,38,0,38,174418,275564,4709
114,Tiruppur (South),VIJAYAKUMAR. A.,IND,27,0,27,174418,275564,4709
115,Palladam,ANANDAN M S M,AIADMK,126437,466,126903,261511,387120,-32691
115,Palladam,MUTHURATHINAM K,DMK,93216,996,94212,261511,387120,-32691
115,Palladam,SUBRAMANIAN S,NTK,20470,54,20524,261511,387120,-32691
115,Palladam,MAYILSAMY G,MNM,10195,32,10227,261511,387120,-32691
115,Palladam,JOTHIMANI R,AMMK,2606,12,2618,261511,387120,-32691
115,Palladam,NOTA,NOTA,1793,9,1802,261511,387120,-32691
115,Palladam,MUTHURATHINAM M,IND,720,2,722,261511,387120,-32691
115,Palladam,THUYAMANI R,IND,690,3,693,261511,387120,-32691
115,Palladam,ANNADURAI R,BSP,607,3,610,261511,387120,-32691
115,Palladam,MURUGESAN K,IND,584,3,587,261511,387120,-32691
115,Palladam,ANTONY MARIARAJ A,Tamil Nadu Ilangyar Katchi,530,0,530,261511,387120,-32691
115,Palladam,MARUTHASALAM V,IND,365,0,365,261511,387120,-32691
115,Palladam,RAMESH V,IND,314,1,315,261511,387120,-32691
115,Palladam,UMANATH R,United States of India Party,307,2,309,261511,387120,-32691
115,Palladam,VIJIYAKUMAR M,IND,214,4,218,261511,387120,-32691
115,Palladam,THANGARAJ A,IND,212,3,215,261511,387120,-32691
115,Palladam,MUTHURATHINAM L,IND,171,0,171,261511,387120,-32691
115,Palladam,SIVAKUMAR G,Anna Puratchi Thalaivar Amma Dravida Munnetra Kazhagam,162,0,162,261511,387120,-32691
115,Palladam,THINAKARAN K,Anna Dravidar Kazhagam,130,0,130,261511,387120,-32691
115,Palladam,SARATHA T,IND,112,0,112,261511,387120,-32691
115,Palladam,SHAHUL HAMEED M,IND,86,0,86,261511,387120,-32691
116,Sulur,KANDASAMY V.P.,AIADMK,118221,747,118968,241653,315431,-31932
116,Sulur,PREMIER SELVAM (a)KALICHAMY M,DMK,85919,1117,87036,241653,315431,-31932
116,Sulur,ELANGOVAN. G,NTK,14376,50,14426,241653,315431,-31932
116,Sulur,RANGANATHAN. A,MNM,12592,66,12658,241653,315431,-31932
116,Sulur,SENTHIL KUMAR. S.A.,AMMK,4087,24,4111,241653,315431,-31932
116,Sulur,NOTA,NOTA,2588,22,2610,241653,315431,-31932
116,Sulur,PREM KUMAR P,IND,380,0,380,241653,315431,-31932
116,Sulur,NAGARAJ. K,Ganasangam Party of India,240,1,241,241653,315431,-31932
116,Sulur,SELVA KUMAR D,IND,213,0,213,241653,315431,-31932
116,Sulur,KARTHIKEYAN P,IND,209,0,209,241653,315431,-31932
116,Sulur,SHANKAR GURU. M,IND,191,5,196,241653,315431,-31932
116,Sulur,SELVAN S,IND,176,1,177,241653,315431,-31932
116,Sulur,JAGADHEESH. S,My India Party,126,2,128,241653,315431,-31932
116,Sulur,SHANMUGAM R,IND,112,4,116,241653,315431,-31932
116,Sulur,SENTHIL KUMAR. S.A.P.,IND,100,1,101,241653,315431,-31932
116,Sulur,KANDASAMY T,IND,82,1,83,241653,315431,-31932
117,Kavundampalayam,G.Arunkumar,AIADMK,134981,688,135669,309918,461006,-9776
117,Kavundampalayam,R.Krishnan,DMK,124557,1336,125893,309918,461006,-9776
117,Kavundampalayam,Pankaj Jain,MNM,23427,100,23527,309918,461006,-9776
117,Kavundampalayam,Kalamani.M,NTK,17823,74,17897,309918,461006,-9776
117,Kavundampalayam,NOTA,NOTA,2868,24,2892,309918,461006,-9776
117,Kavundampalayam,Aruna.M,AMMK,1992,10,2002,309918,461006,-9776
117,Kavundampalayam,Siva.K,Tamil Nadu Ilangyar Katchi,718,8,726,309918,461006,-9776
117,Kavundampalayam,Pushpanantham.V,IND,419,1,420,309918,461006,-9776
117,Kavundampalayam,Arunkumar.T,IND,294,2,296,309918,461006,-9776
117,Kavundampalayam,Selvaraj.M,New Generation People’s Party,177,1,178,309918,461006,-9776
117,Kavundampalayam,Gnanaraj.M,IND,160,1,161,309918,461006,-9776
117,Kavundampalayam,Krishnan.M,IND,140,0,140,309918,461006,-9776
117,Kavundampalayam,Suriyakumar.K,IND,117,0,117,309918,461006,-9776
118,Coimbatore (North),AMMAN K.ARJUNAN,AIADMK,80815,639,81454,202799,336312,-4001
118,Coimbatore (North),SHANMUGASUNDARAM V.M,DMK,76201,1252,77453,202799,336312,-4001
118,Coimbatore (North),THANGAVELU R,MNM,26335,168,26503,202799,336312,-4001
118,Coimbatore (North),Balendran C.B,NTK,11388,45,11433,202799,336312,-4001
118,Coimbatore (North),NOTA,NOTA,1678,23,1701,202799,336312,-4001
118,Coimbatore (North),APPATHURAI N.R,AMMK,1650,9,1659,202799,336312,-4001
118,Coimbatore (North),DURAIRAJ K,Tamil Nadu Ilangyar Katchi,529,2,531,202799,336312,-4001
118,Coimbatore (North),BALAMURUGAN M,IND,313,0,313,202799,336312,-4001
118,Coimbatore (North),KEERTHIGA PARTHASARATHI,IND,245,5,250,202799,336312,-4001
118,Coimbatore (North),BALAJI V,IND,248,0,248,202799,336312,-4001
118,Coimbatore (North),MAHARISHI MANDHARACSALAM,IND,232,1,233,202799,336312,-4001
118,Coimbatore (North),NAVAMANI R,IND,141,0,141,202799,336312,-4001
118,Coimbatore (North),LOGANATHAN M,IND,139,1,140,202799,336312,-4001
118,Coimbatore (North),ARUL MURUGAN A,IND,138,1,139,202799,336312,-4001
118,Coimbatore (North),PANNEER SELVARAJ M,New Generation People’s Party,135,0,135,202799,336312,-4001
118,Coimbatore (North),KANNAPIRAN V,Dravida Murpokku Makkal Katchi,128,0,128,202799,336312,-4001
118,Coimbatore (North),KUMAR G.D.K,IND,124,0,124,202799,336312,-4001
118,Coimbatore (North),RAJKUMAR M.P,Makkal Munnetra Peravai,83,3,86,202799,336312,-4001
118,Coimbatore (North),SHANMUGASUNDARAM K,IND,55,2,57,202799,336312,-4001
118,Coimbatore (North),DALIT. SU. JEYARAJ,IND,49,0,49,202799,336312,-4001
118,Coimbatore (North),RAMESHKUMAR D,IND,22,0,22,202799,336312,-4001
119,Thondamuthur,S.P. VELUMANI,AIADMK,123538,687,124225,230531,324065,-41630
119,Thondamuthur,KARTHIKEYA,DMK,81829,766,82595,230531,324065,-41630
119,Thondamuthur,S. SHAJAHAN,MNM,11572,34,11606,230531,324065,-41630
119,Thondamuthur,S. KALAIARASI,NTK,8014,28,8042,230531,324065,-41630
119,Thondamuthur,NOTA,NOTA,1622,13,1635,230531,324065,-41630
119,Thondamuthur,R.SATHISHKUMAR,AMMK,1229,6,1235,230531,324065,-41630
119,Thondamuthur,A. MANSOOR ALI KHAN,IND,426,2,428,230531,324065,-41630
119,Thondamuthur,J.JOHN EDWARD VISUVASAM,IND,311,1,312,230531,324065,-41630
119,Thondamuthur,CC SELVAMOHAN,IND,173,2,175,230531,324065,-41630
119,Thondamuthur,A. ABDUL GAFOOR,IND,141,1,142,230531,324065,-41630
119,Thondamuthur,M. BADRAN,Ganasangam Party of India,136,0,136,230531,324065,-41630
120,Coimbatore (South),VANATHI SRINIVASAN,BJP,52627,582,53209,154765,251400,-10826
120,Coimbatore (South),KAMALHAASAN,MNM,51087,394,51481,154765,251400,-10826
120,Coimbatore (South),MAYURA S JAYAKUMAR,INC,41663,720,42383,154765,251400,-10826
120,Coimbatore (South),ABDUL WAHAB,NTK,4265,35,4300,154765,251400,-10826
120,Coimbatore (South),NOTA,NOTA,887,14,901,154765,251400,-10826
120,Coimbatore (South),DURAISAMY @ CHALLENGER DURAI,AMMK,690,11,701,154765,251400,-10826
120,Coimbatore (South),ROSHAN,BSP,272,2,274,154765,251400,-10826
120,Coimbatore (South),SUNDARAVADIVELU,IND,190,0,190,154765,251400,-10826
120,Coimbatore (South),DHANDABANI,IND,181,0,181,154765,251400,-10826
120,Coimbatore (South),SELVAKUMAR,IND,163,0,163,154765,251400,-10826
120,Coimbatore (South),PALANIKUMAR.V,IND,136,0,136,154765,251400,-10826
120,Coimbatore (South),NAGAVALLI,IND,134,1,135,154765,251400,-10826
120,Coimbatore (South),GOPALAKRISHNAN,New Generation People’s Party,126,1,127,154765,251400,-10826
120,Coimbatore (South),JAYAPRAKASH.N,IND,99,3,102,154765,251400,-10826
120,Coimbatore (South),SANMUGAVEL,Ganasangam Party of India,76,0,76,154765,251400,-10826
120,Coimbatore (South),VIVEK SUBRAMANIAM,Manitha Urimaigal Kalaagam,74,0,74,154765,251400,-10826
120,Coimbatore (South),RAGHUL GANDHI .K,Hindustan Janta Party,72,1,73,154765,251400,-10826
120,Coimbatore (South),JAYACHANDRAN,IND,62,0,62,154765,251400,-10826
120,Coimbatore (South),VELLIMALAI,"Makkal Sananayaga Kudiyarasu Katchi,",59,0,59,154765,251400,-10826
120,Coimbatore (South),KUMAREASAN. K,IND,58,0,58,154765,251400,-10826
120,Coimbatore (South),ALPHONSERAJ,IND,51,0,51,154765,251400,-10826
120,Coimbatore (South),CHELLADURAI. S,IND,29,0,29,154765,251400,-10826
121,Singanallur,"Jayaram, K.R",AIADMK,80437,807,81244,202021,323633,-10854
121,Singanallur,"Karthik, N",DMK,68984,1406,70390,202021,323633,-10854
121,Singanallur,"Mahendran, R",MNM,36553,302,36855,202021,323633,-10854
121,Singanallur,"Narmadha, R",NTK,8311,55,8366,202021,323633,-10854
121,Singanallur,"Selva, S.R",AMMK,1722,11,1733,202021,323633,-10854
121,Singanallur,NOTA,NOTA,1415,17,1432,202021,323633,-10854
121,Singanallur,"Nabas Sherif, M",IND,257,0,257,202021,323633,-10854
121,Singanallur,"Sasikumar, M",Anna Dravidar Kazhagam,209,2,211,202021,323633,-10854
121,Singanallur,"Chanthirika, R",IND,200,1,201,202021,323633,-10854
121,Singanallur,Praveen Venkatachalam,IND,187,1,188,202021,323633,-10854
121,Singanallur,"Nagarajan, J",IND,163,0,163,202021,323633,-10854
121,Singanallur,"Karthik, N",IND,132,3,135,202021,323633,-10854
121,Singanallur,"Mohandass, N",IND,121,0,121,202021,323633,-10854
121,Singanallur,"Palanisamy, N",My India Party,112,1,113,202021,323633,-10854
121,Singanallur,"SenthilKumar, S",United States of India Party,94,0,94,202021,323633,-10854
121,Singanallur,"Maniraj, K",IND,87,2,89,202021,323633,-10854
121,Singanallur,"Kumar babu, K",IND,87,0,87,202021,323633,-10854
121,Singanallur,"Akbar Ali, A",IND,86,0,86,202021,323633,-10854
121,Singanallur,"Viju Alban Prakash, V",IND,86,0,86,202021,323633,-10854
121,Singanallur,"Karthick, N",IND,72,1,73,202021,323633,-10854
121,Singanallur,"Gowtham, P",IND,65,2,67,202021,323633,-10854
121,Singanallur,"Krishnan, V",IND,30,0,30,202021,323633,-10854
122,Kinathukadavu,Damodaran.S,AIADMK,101069,468,101537,232435,324162,-1095
122,Kinathukadavu,Kuruchi Prabhakaran,DMK,99311,1131,100442,232435,324162,-1095
122,Kinathukadavu,Siva.A,MNM,13880,59,13939,232435,324162,-1095
122,Kinathukadavu,Umajagadesh.M,NTK,11249,31,11280,232435,324162,-1095
122,Kinathukadavu,NOTA,NOTA,2268,12,2280,232435,324162,-1095
122,Kinathukadavu,ROHINI MA.PA,AMMK,1237,11,1248,232435,324162,-1095
122,Kinathukadavu,Velusamy.V,IND,504,1,505,232435,324162,-1095
122,Kinathukadavu,Anbazhagan.G,Veerath Thiyagi Viswanathadoss Thozhilalarkal Katchi,352,1,353,232435,324162,-1095
122,Kinathukadavu,Nagendran.P,IND,225,3,228,232435,324162,-1095
122,Kinathukadavu,Mariappan.R,Ganasangam Party of India,187,0,187,232435,324162,-1095
122,Kinathukadavu,Noor Muhamad . A,IND,135,0,135,232435,324162,-1095
122,Kinathukadavu,Dharmalingam.K,IND,107,1,108,232435,324162,-1095
122,Kinathukadavu,Nazir Babu.S,IND,88,0,88,232435,324162,-1095
122,Kinathukadavu,James.S,All India Jananayaka Makkal Kazhagam,55,0,55,232435,324162,-1095
122,Kinathukadavu,Atheeswaran.S,IND,50,0,50,232435,324162,-1095
123,Pollachi,Pollachi V. Jayaraman,AIADMK,79906,661,80567,177308,224833,-1725
123,Pollachi,"Dr. Varadharajan, K.",DMK,77882,960,78842,177308,224833,-1725
123,Pollachi,"Sathieshkumar, V.T.",MNM,7548,41,7589,177308,224833,-1725
123,Pollachi,"Logeswari, N.",NTK,6375,27,6402,177308,224833,-1725
123,Pollachi,NOTA,NOTA,1533,13,1546,177308,224833,-1725
123,Pollachi,"Sugumar, K.",AMMK,1135,6,1141,177308,224833,-1725
123,Pollachi,"Aruchamy, C.M.",BSP,488,3,491,177308,224833,-1725
123,Pollachi,"Shanthu Mohamed, A.",IND,368,0,368,177308,224833,-1725
123,Pollachi,"Muthukumarasamy, R.",IND,361,1,362,177308,224833,-1725
124,Valparai,AMULKANDASAMI T K,AIADMK,71128,544,71672,145172,205344,-12223
124,Valparai,ARUMUGAM M,CPI,58821,628,59449,145172,205344,-12223
124,Valparai,KOHILA C,NTK,7588,44,7632,145172,205344,-12223
124,Valparai,SENTHILRAJ D,MNM,3291,23,3314,145172,205344,-12223
124,Valparai,NOTA,NOTA,1409,6,1415,145172,205344,-12223
124,Valparai,MURUGARAJ M S,DMDK,1327,8,1335,145172,205344,-12223
124,Valparai,RANGASAMY T M,IND,353,2,355,145172,205344,-12223
125,Udumalaipettai,"Radhakrishnan,K.",AIADMK,95953,940,96893,194358,269142,-21895
125,Udumalaipettai,"Thennarasu,K.",INC,73788,1210,74998,194358,269142,-21895
125,Udumalaipettai,"Babu Ranjendra Prasad,A.",NTK,8540,52,8592,194358,269142,-21895
125,Udumalaipettai,"Srinithi,V.",MNM,8107,56,8163,194358,269142,-21895
125,Udumalaipettai,NOTA,NOTA,1469,9,1478,194358,269142,-21895
125,Udumalaipettai,"Palanisamy,R.",AMMK,1038,5,1043,194358,269142,-21895
125,Udumalaipettai,"Dhivya,D.",IND,785,2,787,194358,269142,-21895
125,Udumalaipettai,"Krishnan,T.",Anna Puratchi Thalaivar Amma Dravida Munnetra Kazhagam,680,3,683,194358,269142,-21895
125,Udumalaipettai,"Kumar,K.",BSP,456,3,459,194358,269142,-21895
125,Udumalaipettai,"Rajini,K.",IND,300,0,300,194358,269142,-21895
125,Udumalaipettai,"Umar Ali,D.",IND,217,7,224,194358,269142,-21895
125,Udumalaipettai,"Arumugam,P.",IND,182,2,184,194358,269142,-21895
125,Udumalaipettai,"Karthikeyan,S.",IND,180,1,181,194358,269142,-21895
125,Udumalaipettai,"Nachammal,K.",Anaithu Makkal Arasiyal Katchi,175,2,177,194358,269142,-21895
125,Udumalaipettai,"Elsy,C.",IND,124,2,126,194358,269142,-21895
125,Udumalaipettai,"Ashokkumar,S.",IND,70,0,70,194358,269142,-21895
126,Madathukulam,C MAHENDRAN,AIADMK,83634,679,84313,181902,247655,-6438
126,Madathukulam,R.JAYARAMAKRISHNAN,DMK,76885,990,77875,181902,247655,-6438
126,Madathukulam,C.SHANMUGAVELU,AMMK,6467,48,6515,181902,247655,-6438
126,Madathukulam,U SANUJA,NTK,6200,45,6245,181902,247655,-6438
126,Madathukulam,K KUMARESAN,MNM,2877,17,2894,181902,247655,-6438
126,Madathukulam,NOTA,NOTA,1042,6,1048,181902,247655,-6438
126,Madathukulam,G RAMAKRISHNAN,IND,711,1,712,181902,247655,-6438
126,Madathukulam,K MAHENDRAKUMAR,IND,609,2,611,181902,247655,-6438
126,Madathukulam,K MANICKASAMY,IND,503,0,503,181902,247655,-6438
126,Madathukulam,J.BENJAMIN KIRUBAKARAN,BSP,465,2,467,181902,247655,-6438
126,Madathukulam,P MAHENDRAN,IND,171,1,172,181902,247655,-6438
126,Madathukulam,K.MAHALINGAM,IND,136,5,141,181902,247655,-6438
126,Madathukulam,M SHANMUGAVEL,IND,130,0,130,181902,247655,-6438
126,Madathukulam,K SAKTHIVEL,Anna Puratchi Thalaivar Amma Dravida Munnetra Kazhagam,105,0,105,181902,247655,-6438
126,Madathukulam,P THANGARAJ,IND,86,2,88,181902,247655,-6438
126,Madathukulam,P SUBRAMANIAN,IND,83,0,83,181902,247655,-6438
127,Palani,SENTHIL KUMAR I.P,DMK,107049,1517,108566,205384,277811,30056
127,Palani,RAVI MANOHARAN K,AIADMK,77951,559,78510,205384,277811,30056
127,Palani,VINOTH RAJASEKARAN G,NTK,7563,93,7656,205384,277811,30056
127,Palani,POOVENDHAN T,MNM,3669,63,3732,205384,277811,30056
127,Palani,VEERAKUMAR V,AMMK,2231,24,2255,205384,277811,30056
127,Palani,NOTA,NOTA,1088,22,1110,205384,277811,30056
127,Palani,SIVABALA MOORTHI K,Akhil Bharat Hindu Mahasabha,598,3,601,205384,277811,30056
127,Palani,SUDHA R B,IND,520,2,522,205384,277811,30056
127,Palani,SURESH M,IND,462,0,462,205384,277811,30056
127,Palani,NACHIMUTHU S,BSP,442,1,443,205384,277811,30056
127,Palani,NAGENDRAN G,IND,308,2,310,205384,277811,30056
127,Palani,SAMIAPPA GOUNDER P,IND,195,0,195,205384,277811,30056
127,Palani,SHAHUL HAMEED,IND,147,2,149,205384,277811,30056
127,Palani,SIDDIQ M,IND,110,0,110,205384,277811,30056
127,Palani,LATHIKA,IND,105,1,106,205384,277811,30056
127,Palani,PERIYADURAI M,IND,94,1,95,205384,277811,30056
127,Palani,ANANTHAN S. P,IND,92,0,92,205384,277811,30056
127,Palani,THANGAVEL B,My India Party,76,1,77,205384,277811,30056
127,Palani,MUNISHRAJA M,IND,73,0,73,205384,277811,30056
127,Palani,PANDEESWARAN M,IND,68,0,68,205384,277811,30056
127,Palani,RASULBEEVI SAHABUDEEN,IND,64,0,64,205384,277811,30056
127,Palani,THANGAVEL A,IND,58,0,58,205384,277811,30056
127,Palani,KALIAPPAN K,IND,47,2,49,205384,277811,30056
127,Palani,AZHAGUMALAI A,IND,43,0,43,205384,277811,30056
127,Palani,KARUPPUSAMY P,IND,37,1,38,205384,277811,30056
128,Oddanchatram,SAKKARAPANI R,DMK,108990,980,109970,201756,240210,28742
128,Oddanchatram,NATARAJ N.P,AIADMK,80819,409,81228,201756,240210,28742
128,Oddanchatram,SAKTHI DEVI T,NTK,4892,52,4944,201756,240210,28742
128,Oddanchatram,NOTA,NOTA,1451,6,1457,201756,240210,28742
128,Oddanchatram,SIVA KUMAR M,DMDK,1417,10,1427,201756,240210,28742
128,Oddanchatram,ABDUL HADI A,MNM,1069,13,1082,201756,240210,28742
128,Oddanchatram,MURUGARAJ P,BSP,527,2,529,201756,240210,28742
128,Oddanchatram,MARIMUTHU T.S,IND,406,1,407,201756,240210,28742
128,Oddanchatram,BALASUBRAMANI S,IND,356,0,356,201756,240210,28742
128,Oddanchatram,CHELLAMUTHU K,IND,100,0,100,201756,240210,28742
128,Oddanchatram,RAVI M,Anaithu Makkal Puratchi Katchi,61,0,61,201756,240210,28742
128,Oddanchatram,SIVANESAN K,IND,59,0,59,201756,240210,28742
128,Oddanchatram,RAVICHANDRAN K,My India Party,52,0,52,201756,240210,28742
128,Oddanchatram,SIVAPRAKASH S,IND,44,0,44,201756,240210,28742
128,Oddanchatram,SHANMUGAVEL P,IND,40,0,40,201756,240210,28742
129,Athoor,PERIYASAMY I,DMK,164169,1640,165809,229940,290708,135571
129,Athoor,THILAGABAMA M,PMK,30018,220,30238,229940,290708,135571
129,Athoor,SIMON JUSTIN A,NTK,17017,151,17168,229940,290708,135571
129,Athoor,SIVASAKTHIVEL P,MNM,3211,30,3241,229940,290708,135571
129,Athoor,SELVAKUMAR P,AMMK,2991,26,3017,229940,290708,135571
129,Athoor,SAVADAMUTHU A,IND,1706,16,1722,229940,290708,135571
129,Athoor,NOTA,NOTA,1543,21,1564,229940,290708,135571
129,Athoor,PALRAJ R,IND,1352,5,1357,229940,290708,135571
129,Athoor,MUTHULAKSHMI R,Anna Puratchi Thalaivar Amma Dravida Munnetra Kazhagam,1178,2,1180,229940,290708,135571
129,Athoor,SILAMBARASAN M,PT,878,2,880,229940,290708,135571
129,Athoor,KARTHIGAISELVAN K,BSP,740,9,749,229940,290708,135571
129,Athoor,SANKAR D,IND,700,0,700,229940,290708,135571
129,Athoor,ANBU AS,IND,534,1,535,229940,290708,135571
129,Athoor,SILAMBARASAN P,IND,486,0,486,229940,290708,135571
129,Athoor,THILAGAVATHY S,IND,347,2,349,229940,290708,135571
129,Athoor,KARTHI M,IND,321,1,322,229940,290708,135571
129,Athoor,BALAMURUGAN A,IND,190,0,190,229940,290708,135571
129,Athoor,VEERAMALAI S,IND,133,0,133,229940,290708,135571
129,Athoor,MURUGANANTHAM C,IND,125,0,125,229940,290708,135571
129,Athoor,JEYASEKARAN R,My India Party,87,1,88,229940,290708,135571
129,Athoor,RAGUPATHI P,Anaithu Makkal Puratchi Katchi,87,0,87,229940,290708,135571
130,Nilakkottai,S.Thenmozhi,AIADMK,90857,604,91461,184805,241896,-27618
130,Nilakkottai,K.Murugavelrajan,DMK,62593,1250,63843,184805,241896,-27618
130,Nilakkottai,G.Vasanthadevi,NTK,17363,142,17505,184805,241896,-27618
130,Nilakkottai,K.Ramasamy,DMDK,3684,20,3704,184805,241896,-27618
130,Nilakkottai,Ananth,MNM,3146,35,3181,184805,241896,-27618
130,Nilakkottai,NOTA,NOTA,1248,12,1260,184805,241896,-27618
130,Nilakkottai,P.Nagendran,BSP,664,2,666,184805,241896,-27618
130,Nilakkottai,P.Nagajothi,IND,511,4,515,184805,241896,-27618
130,Nilakkottai,V.Vinoth,IND,491,0,491,184805,241896,-27618
130,Nilakkottai,V.K.Aiyyar,PT,478,6,484,184805,241896,-27618
130,Nilakkottai,P.Pothumanickam,IND,372,3,375,184805,241896,-27618
130,Nilakkottai,A.Alappan,IND,340,3,343,184805,241896,-27618
130,Nilakkottai,N.Perumal,IND,252,0,252,184805,241896,-27618
130,Nilakkottai,V.Balasubramani,IND,163,1,164,184805,241896,-27618
130,Nilakkottai,V.Revadhi,My India Party,155,3,158,184805,241896,-27618
130,Nilakkottai,M.Pandi,IND,135,2,137,184805,241896,-27618
130,Nilakkottai,S.Nithya,IND,126,2,128,184805,241896,-27618
130,Nilakkottai,P.Sivakami,IND,76,1,77,184805,241896,-27618
130,Nilakkottai,M.Kalimuthu,IND,61,0,61,184805,241896,-27618
131,Natham,NATHAM.R.VISWANATHAN,AIADMK,107255,507,107762,225244,281606,-11932
131,Natham,M.A.ANDI AMBALAM,DMK,94968,862,95830,225244,281606,-11932
131,Natham,DOCTOR.V.SIVASANKARAN,NTK,14673,89,14762,225244,281606,-11932
131,Natham,N.RAJA,AMMK,1713,8,1721,225244,281606,-11932
131,Natham,NOTA,NOTA,1438,6,1444,225244,281606,-11932
131,Natham,R.A.SARANRAJ,Indiya Jananayaka Katchi,1019,6,1025,225244,281606,-11932
131,Natham,P.ANDISAMY,BSP,676,2,678,225244,281606,-11932
131,Natham,S.JEYAKUMAR,IND,383,0,383,225244,281606,-11932
131,Natham,A.KARNAN,IND,335,0,335,225244,281606,-11932
131,Natham,K.DHANDAPANI,IND,321,1,322,225244,281606,-11932
131,Natham,K.MURUGESAN,IND,224,0,224,225244,281606,-11932
131,Natham,M.XAVIER JOSEPH KENNEDY,IND,189,5,194,225244,281606,-11932
131,Natham,JEYAPAUL R,IND,190,0,190,225244,281606,-11932
131,Natham,V.VEMBARASAN,My India Party,164,2,166,225244,281606,-11932
131,Natham,A.BALASUBRAMANI,IND,112,0,112,225244,281606,-11932
131,Natham,C.GURUSAMY,IND,95,1,96,225244,281606,-11932
132,Dindigul,SREENIVASAN.C,AIADMK,89685,910,90595,195118,275988,-17747
132,Dindigul,PANDI.N,CPM,70393,2455,72848,195118,275988,-17747
132,Dindigul,JAYASUNDAR.R,NTK,14703,157,14860,195118,275988,-17747
132,Dindigul,RAJENDRAN.R,MNM,8950,113,9063,195118,275988,-17747
132,Dindigul,RAMUTHEVAR.P,AMMK,2379,48,2427,195118,275988,-17747
132,Dindigul,NOTA,NOTA,1772,35,1807,195118,275988,-17747
132,Dindigul,BALASUBRAMANI.K,IND,561,9,570,195118,275988,-17747
132,Dindigul,ARASUR MANOHARAN.S,BSP,492,9,501,195118,275988,-17747
132,Dindigul,BASKARAN CHELLAPPA.J,IND,344,1,345,195118,275988,-17747
132,Dindigul,AKKAMMAL.S,My India Party,301,4,305,195118,275988,-17747
132,Dindigul,MURUGESAN.A,PT,245,9,254,195118,275988,-17747
132,Dindigul,ALAGU PANDIAN.R,Anaithu Makkal Munnetra Kazhagam,232,0,232,195118,275988,-17747
132,Dindigul,RAHAMATHULLA.M,IND,209,1,210,195118,275988,-17747
132,Dindigul,ANBUROSE.D,IND,190,1,191,195118,275988,-17747
132,Dindigul,NAGARAJ.N,IND,179,1,180,195118,275988,-17747
132,Dindigul,DHANASEKARAN.C,IND,165,1,166,195118,275988,-17747
132,Dindigul,HARI PRAKASH.M,IND,118,1,119,195118,275988,-17747
132,Dindigul,VIJAYAPANDI.P,IND,109,5,114,195118,275988,-17747
132,Dindigul,BALAJI.R,IND,104,0,104,195118,275988,-17747
132,Dindigul,KARTHIKEYAN.V,Anna Puratchi Thalaivar Amma Dravida Munnetra Kazhagam,92,0,92,195118,275988,-17747
132,Dindigul,SENTHIL ALAGAPPAN.A,IND,81,1,82,195118,275988,-17747
132,Dindigul,SIVAGANAM.A,Anaithu Makkal Puratchi Katchi,51,2,53,195118,275988,-17747
133,Vedasandur,GANDHIRAJAN S,DMK,105157,1324,106481,213080,263268,17553
133,Vedasandur,PARAMASIVAM V P B,AIADMK,88330,598,88928,213080,263268,17553
133,Vedasandur,POTHUMANI R,NTK,8441,54,8495,213080,263268,17553
133,Vedasandur,RAMASAMY P,AMMK,2030,11,2041,213080,263268,17553
133,Vedasandur,PALANICHAMY B,IND,1292,1,1293,213080,263268,17553
133,Vedasandur,VETRIVEL S,MNM,1202,13,1215,213080,263268,17553
133,Vedasandur,PRASATH R,IND,886,1,887,213080,263268,17553
133,Vedasandur,NOTA,NOTA,798,5,803,213080,263268,17553
133,Vedasandur,MUTHUSAMY V,IND,739,1,740,213080,263268,17553
133,Vedasandur,KARTHIKEYAN A,My India Party,669,0,669,213080,263268,17553
133,Vedasandur,MURUGAN P,IND,489,0,489,213080,263268,17553
133,Vedasandur,SUKUMAR V,IND,233,0,233,213080,263268,17553
133,Vedasandur,NANDAKUMAR P,IND,124,0,124,213080,263268,17553
133,Vedasandur,MURUGESAN K,Ganasangam Party of India,123,0,123,213080,263268,17553
133,Vedasandur,MANEESHANKAR M G,Rashtriya Samaj Paksha,105,3,108,213080,263268,17553
133,Vedasandur,KALIMUTHU V,Samaniya Makkal Nala Katchi,101,0,101,213080,263268,17553
133,Vedasandur,DHARMALINGAM Dr MARUR N,IND,78,3,81,213080,263268,17553
133,Vedasandur,MOORTHY S,IND,77,0,77,213080,263268,17553
133,Vedasandur,SARAVANA KUMAR K R,IND,71,1,72,213080,263268,17553
133,Vedasandur,SELVARAJ V,IND,71,0,71,213080,263268,17553
133,Vedasandur,RAMASAMY K,IND,48,1,49,213080,263268,17553
134,Aravakurichi,ELANGO. R,DMK,92215,1154,93369,177114,213138,24816
134,Aravakurichi,ANNAMALAI. K,BJP,67915,638,68553,177114,213138,24816
134,Aravakurichi,ANITHA PARVEEN. M,NTK,7156,32,7188,177114,213138,24816
134,Aravakurichi,THANGAVEL.  P. S. N,AMMK,1593,6,1599,177114,213138,24816
134,Aravakurichi,MOHAMMED HANEEF SHAHIL. K. S,MNM,1375,7,1382,177114,213138,24816
134,Aravakurichi,SARAVANAN. P,IND,1236,0,1236,177114,213138,24816
134,Aravakurichi,NOTA,NOTA,866,3,869,177114,213138,24816
134,Aravakurichi,RAJKUMAR. R,Tamil Nadu Ilangyar Katchi,375,2,377,177114,213138,24816
134,Aravakurichi,SATHEESHKUMAR. T,IND,336,0,336,177114,213138,24816
134,Aravakurichi,SUNDARARAJ. R,BSP,328,0,328,177114,213138,24816
134,Aravakurichi,MANOJPANDIYAN. J. M,IND,290,0,290,177114,213138,24816
134,Aravakurichi,CHITHAMBARAM. A,IND,240,0,240,177114,213138,24816
134,Aravakurichi,MURUGESAN. M. S,IND,174,0,174,177114,213138,24816
134,Aravakurichi,MATHIYALAGAN. P,IND,161,0,161,177114,213138,24816
134,Aravakurichi,SILAMBARASAN. P,IND,129,0,129,177114,213138,24816
134,Aravakurichi,MAHESHMANI. T,IND,104,0,104,177114,213138,24816
134,Aravakurichi,SAKUNTHALA. N,IND,79,0,79,177114,213138,24816
134,Aravakurichi,KARTHIKEYAN. R,IND,63,0,63,177114,213138,24816
134,Aravakurichi,ARIVALAGAN. T,IND,53,0,53,177114,213138,24816
134,Aravakurichi,VAIRASEEMAN. G,IND,46,0,46,177114,213138,24816
134,Aravakurichi,KARTHIK. D,IND,45,0,45,177114,213138,24816
134,Aravakurichi,RAJENDIRAN. M,IND,44,0,44,177114,213138,24816
134,Aravakurichi,KIRUBANANTH. S,IND,41,0,41,177114,213138,24816
134,Aravakurichi,PERIYASAMY. M. R,IND,40,0,40,177114,213138,24816
134,Aravakurichi,ARUMUGAM. R,IND,29,0,29,177114,213138,24816
134,Aravakurichi,SIVAKUMAR. A,IND,28,0,28,177114,213138,24816
134,Aravakurichi,BOOPATHY. S,IND,27,0,27,177114,213138,24816
134,Aravakurichi,BASKARAN. N,IND,24,1,25,177114,213138,24816
134,Aravakurichi,PITCHAIMUTHU. T,IND,24,0,24,177114,213138,24816
134,Aravakurichi,SURESHBABU. S,IND,24,0,24,177114,213138,24816
134,Aravakurichi,RAGUNATH. P,IND,23,0,23,177114,213138,24816
134,Aravakurichi,MOHANRAJ. C,Samaniya Makkal Nala Katchi,21,1,22,177114,213138,24816
134,Aravakurichi,PRABAKARAN. T,IND,20,1,21,177114,213138,24816
134,Aravakurichi,THANEGASALAM. R. V,IND,20,1,21,177114,213138,24816
134,Aravakurichi,RANJITH. I,IND,21,0,21,177114,213138,24816
134,Aravakurichi,RAMAGURU. R,IND,19,1,20,177114,213138,24816
134,Aravakurichi,SELVAKUMAR. R,IND,19,0,19,177114,213138,24816
134,Aravakurichi,SURESH. M,IND,19,0,19,177114,213138,24816
134,Aravakurichi,PRABHU. G,IND,16,0,16,177114,213138,24816
134,Aravakurichi,PRAKASH. P,IND,16,0,16,177114,213138,24816
134,Aravakurichi,VIVEKANANTHAN. V,IND,13,0,13,177114,213138,24816
135,Karur,SENTHILBALAJI V,DMK,100356,1401,101757,207310,244195,12448
135,Karur,VIJAYABHASKAR. M.R,AIADMK,88440,869,89309,207310,244195,12448
135,Karur,KARUPPAIYA.R,NTK,7286,30,7316,207310,244195,12448
135,Karur,MOHANRAJ.S,MNM,4138,16,4154,207310,244195,12448
135,Karur,NOTA,NOTA,954,7,961,207310,244195,12448
135,Karur,THANGARAJ.N,DMDK,946,7,953,207310,244195,12448
135,Karur,RAVI.P,IND,366,3,369,207310,244195,12448
135,Karur,ANBAZHAGAN,IND,334,0,334,207310,244195,12448
135,Karur,AADHIKRISHNAN.P,BSP,210,0,210,207310,244195,12448
135,Karur,KANNAN.T,IND,165,0,165,207310,244195,12448
135,Karur,RAJESHKANNAN.S,IND,138,0,138,207310,244195,12448
135,Karur,KATHIRAVAN.P,IND,114,0,114,207310,244195,12448
135,Karur,DHANALAKSHMI.M,Ganasangam Party of India,105,0,105,207310,244195,12448
135,Karur,JAYAKUMAR.G,IND,100,2,102,207310,244195,12448
135,Karur,SHANMUGAM.N,Samaniya Makkal Nala Katchi,99,0,99,207310,244195,12448
135,Karur,SURYA,IND,96,0,96,207310,244195,12448
135,Karur,MURUGESAN.A,IND,83,1,84,207310,244195,12448
135,Karur,BALAMANIKANDAN.K,IND,56,0,56,207310,244195,12448
135,Karur,AMARSRI.M,IND,56,0,56,207310,244195,12448
135,Karur,KALAI RAJ.K,IND,51,0,51,207310,244195,12448
135,Karur,SIVAKUMAR.V,IND,46,0,46,207310,244195,12448
135,Karur,MOHAN.M.L.M,IND,42,0,42,207310,244195,12448
135,Karur,KRISHNAKUMAR.S,IND,42,0,42,207310,244195,12448
135,Karur,JOSEPH.M.A,Desiya Makkal Sakthi Katchi,39,0,39,207310,244195,12448
135,Karur,SIVASAMY.P,IND,37,0,37,207310,244195,12448
135,Karur,MURUGANANTHAM.T,IND,30,0,30,207310,244195,12448
135,Karur,SHIVAKUMAR.K,IND,29,0,29,207310,244195,12448
135,Karur,ABILAZAN.N,IND,29,0,29,207310,244195,12448
135,Karur,KARUNAMOORTHY.S,IND,29,0,29,207310,244195,12448
135,Karur,AMARNATH.K,IND,28,0,28,207310,244195,12448
135,Karur,VENKATESH PRABU.K,IND,26,0,26,207310,244195,12448
135,Karur,VIGNESHWARAN.P,IND,25,0,25,207310,244195,12448
135,Karur,JOTHI SUTHARSAN,IND,22,0,22,207310,244195,12448
135,Karur,PRAKASH.N,IND,20,0,20,207310,244195,12448
135,Karur,GOPALAKRISHNAN.A,IND,19,0,19,207310,244195,12448
135,Karur,SUDHAKAR.L,IND,19,0,19,207310,244195,12448
135,Karur,SIVAKUMAR.N,IND,18,0,18,207310,244195,12448
135,Karur,PALANIVEL.P,IND,17,0,17,207310,244195,12448
135,Karur,BANUMATHY,IND,16,0,16,207310,244195,12448
135,Karur,KAMARAJ.P,IND,15,0,15,207310,244195,12448
135,Karur,MOUNAGURUBALUSAMY.K,IND,14,0,14,207310,244195,12448
135,Karur,VENKADESH.K,IND,14,0,14,207310,244195,12448
135,Karur,MUTHU. K.R,IND,14,0,14,207310,244195,12448
135,Karur,VIJAYABHASKAR.R.V,IND,14,0,14,207310,244195,12448
135,Karur,DEEPANANDH.N,IND,14,0,14,207310,244195,12448
135,Karur,VIJAYAN.K,IND,13,0,13,207310,244195,12448
135,Karur,THIRUGNANAM.M,IND,13,0,13,207310,244195,12448
135,Karur,NOOR MOHAMMED THOUFFIC.A,IND,13,0,13,207310,244195,12448
135,Karur,SENTHILKUMAR.A,IND,13,0,13,207310,244195,12448
135,Karur,TAMILARASAN.K,IND,13,0,13,207310,244195,12448
135,Karur,SAMIVEL.A,IND,12,0,12,207310,244195,12448
135,Karur,MAHENDRAN,IND,11,0,11,207310,244195,12448
135,Karur,DANIYA,IND,11,0,11,207310,244195,12448
135,Karur,PRAKASH.A,IND,11,0,11,207310,244195,12448
135,Karur,MANOJ.P,IND,10,0,10,207310,244195,12448
135,Karur,SATHISH.P,IND,10,0,10,207310,244195,12448
135,Karur,SARAVANAN.R,IND,10,0,10,207310,244195,12448
135,Karur,SAMIAPPAN.K,IND,10,0,10,207310,244195,12448
135,Karur,MURALI.M,IND,10,0,10,207310,244195,12448
135,Karur,VINOTHKUMAR,IND,9,0,9,207310,244195,12448
135,Karur,SAMPATH.S,IND,9,0,9,207310,244195,12448
135,Karur,MUTHUKUMAR.G,IND,8,0,8,207310,244195,12448
135,Karur,SUBASH MALAYALAM.T,IND,8,0,8,207310,244195,12448
135,Karur,DHANABAL,IND,7,0,7,207310,244195,12448
135,Karur,SELVAKUMAR.M,IND,7,0,7,207310,244195,12448
135,Karur,SUDHAKAR.S,IND,7,0,7,207310,244195,12448
135,Karur,THAMILALAGAN,IND,7,0,7,207310,244195,12448
135,Karur,BOOPATHI.P,IND,6,0,6,207310,244195,12448
135,Karur,VEERAKUMAR.T,IND,5,0,5,207310,244195,12448
135,Karur,DURAISAMY.J,IND,5,0,5,207310,244195,12448
135,Karur,PRAKASH.V,IND,5,0,5,207310,244195,12448
135,Karur,SANTHANAKUMAR.M,IND,3,1,4,207310,244195,12448
135,Karur,PRASANTH.S,IND,4,0,4,207310,244195,12448
135,Karur,PUSHPARAJ.P,IND,3,0,3,207310,244195,12448
135,Karur,MANIVANNAN.S,IND,3,0,3,207310,244195,12448
135,Karur,MANIKANDAN.K,IND,2,0,2,207310,244195,12448
135,Karur,SENTHILKUMAR.A.M,IND,2,0,2,207310,244195,12448
135,Karur,SAKTHIKUMAR,IND,2,0,2,207310,244195,12448
136,Krishnarayapuram,SIVAGAMA SUNDARI.K,DMK,95321,1219,96540,180902,212653,31625
136,Krishnarayapuram,MUTHUKUMAR,AIADMK,64507,408,64915,180902,212653,31625
136,Krishnarayapuram,ILAKIYA.R,NTK,9654,52,9706,180902,212653,31625
136,Krishnarayapuram,KATHIRVEL.M,DMDK,1940,6,1946,180902,212653,31625
136,Krishnarayapuram,SARAVANAN.V,MNM,1837,11,1848,180902,212653,31625
136,Krishnarayapuram,NOTA,NOTA,1172,5,1177,180902,212653,31625
136,Krishnarayapuram,SIVAKUMAR. O,IND,910,1,911,180902,212653,31625
136,Krishnarayapuram,SELVAKUMAR.S,IND,710,0,710,180902,212653,31625
136,Krishnarayapuram,MURUGESAN.R,BSP,538,2,540,180902,212653,31625
136,Krishnarayapuram,SATHYARAJ,IND,433,0,433,180902,212653,31625
136,Krishnarayapuram,CHINNASAMY.V,IND,377,0,377,180902,212653,31625
136,Krishnarayapuram,TAMIL SELVAN.M,IND,242,0,242,180902,212653,31625
136,Krishnarayapuram,SENTHILKUMAR.M,IND,214,0,214,180902,212653,31625
136,Krishnarayapuram,ASHOKAN.P,PT,194,1,195,180902,212653,31625
136,Krishnarayapuram,SAKTHIVEL.K,IND,151,0,151,180902,212653,31625
136,Krishnarayapuram,CHANDRA.P,My India Party,128,0,128,180902,212653,31625
136,Krishnarayapuram,RAJAGURU. M,Samaniya Makkal Nala Katchi,121,1,122,180902,212653,31625
136,Krishnarayapuram,KRISHNAMOORTHI.M,IND,119,0,119,180902,212653,31625
136,Krishnarayapuram,RAJAGOPAL.K,IND,113,0,113,180902,212653,31625
136,Krishnarayapuram,RAMESH.N.P,IND,107,1,108,180902,212653,31625
136,Krishnarayapuram,NARAYANAN.KR,CPI(ML)(L),100,1,101,180902,212653,31625
136,Krishnarayapuram,GOPI KRISHNAN.P,IND,97,0,97,180902,212653,31625
136,Krishnarayapuram,MURUGANANTHAM.T,IND,69,0,69,180902,212653,31625
136,Krishnarayapuram,NAGARAJAN. C,IND,68,0,68,180902,212653,31625
136,Krishnarayapuram,MAHAMUNI.A,IND,27,0,27,180902,212653,31625
136,Krishnarayapuram,MAHESWARAN.A,IND,24,0,24,180902,212653,31625
136,Krishnarayapuram,MUHILAN.T,IND,21,0,21,180902,212653,31625
137,Kulithalai,R.Manickam,DMK,99285,1544,100829,197456,226788,23540
137,Kulithalai,N.R.Chandrasekar,AIADMK,76579,710,77289,197456,226788,23540
137,Kulithalai,Seeni.Prakasu,NTK,11426,85,11511,197456,226788,23540
137,Kulithalai,NOTA,NOTA,1187,4,1191,197456,226788,23540
137,Kulithalai,R.Saravanan,IND,834,4,838,197456,226788,23540
137,Kulithalai,V.Nirosha,AMMK,754,7,761,197456,226788,23540
137,Kulithalai,R.Chandrasekar,IND,674,20,694,197456,226788,23540
137,Kulithalai,S.Manikandan,Indiya Jananayaka Katchi,670,4,674,197456,226788,23540
137,Kulithalai,V.Vellaiyan,IND,612,0,612,197456,226788,23540
137,Kulithalai,P.Anbalagan,BSP,585,5,590,197456,226788,23540
137,Kulithalai,K.Suresh,IND,490,4,494,197456,226788,23540
137,Kulithalai,M.Sankar,Samaniya Makkal Nala Katchi,455,5,460,197456,226788,23540
137,Kulithalai,B.Selvaraj,IND,399,0,399,197456,226788,23540
137,Kulithalai,V.Alex Mouris,IND,244,1,245,197456,226788,23540
137,Kulithalai,M.Saravanan,IND,213,8,221,197456,226788,23540
137,Kulithalai,A.Subethar,Tipu Sultan Party,213,2,215,197456,226788,23540
137,Kulithalai,S.Barani,IND,184,0,184,197456,226788,23540
137,Kulithalai,S.Kandasamy,IND,138,0,138,197456,226788,23540
137,Kulithalai,R.Kalyana Sundaram,IND,109,2,111,197456,226788,23540
138,Manapparai,ABDUL SAMAD P,DMK,96204,1873,98077,221748,288997,12243
138,Manapparai,CHANDRASEKAR.R,AIADMK,85133,701,85834,221748,288997,12243
138,Manapparai,KANIMOZHI.P,NTK,19358,92,19450,221748,288997,12243
138,Manapparai,KRISHNAGOPAL P,DMDK,10666,53,10719,221748,288997,12243
138,Manapparai,CHANDRASEKAR V,IND,1255,4,1259,221748,288997,12243
138,Manapparai,NOTA,NOTA,1002,7,1009,221748,288997,12243
138,Manapparai,UMARANI K,Indiya Jananayaka Katchi,908,6,914,221748,288997,12243
138,Manapparai,CHINNAN P,IND,649,1,650,221748,288997,12243
138,Manapparai,SUBRAMANIAN P,IND,628,0,628,221748,288997,12243
138,Manapparai,ELAYARAJA C,IND,544,3,547,221748,288997,12243
138,Manapparai,NIRMAL KUMAR M,IND,543,1,544,221748,288997,12243
138,Manapparai,SATHYA PRIYA A,IND,301,6,307,221748,288997,12243
138,Manapparai,ARPUTHASAMY V,IND,286,1,287,221748,288997,12243
138,Manapparai,CHITHAIYAN T,IND,261,9,270,221748,288997,12243
138,Manapparai,SAKTHIVEL.M,CPI(ML)(L),186,5,191,221748,288997,12243
138,Manapparai,DAVID P,IND,179,1,180,221748,288997,12243
138,Manapparai,KARTHICK KRISHNA P,IND,173,0,173,221748,288997,12243
138,Manapparai,RASU P,IND,169,0,169,221748,288997,12243
138,Manapparai,PANDIAN V,Ezhuchi Tamilargal Munnetra Kazhagam,128,1,129,221748,288997,12243
138,Manapparai,ILANGOVAN S,IND,122,1,123,221748,288997,12243
138,Manapparai,PRASANNA KUMAR P,IND,113,0,113,221748,288997,12243
138,Manapparai,JEYAPANDIAN D,IND,93,0,93,221748,288997,12243
138,Manapparai,VARADAN.M,Lok Jan Shakti Party,81,1,82,221748,288997,12243
139,Srirangam,Palaniyandi.M,DMK,112009,1895,113904,240240,310744,19915
139,Srirangam,KuPa Krishnan,AIADMK,93131,858,93989,240240,310744,19915
139,Srirangam,K.Selvarathi,NTK,17793,118,17911,240240,310744,19915
139,Srirangam,Y.Jacob,IND,4031,51,4082,240240,310744,19915
139,Srirangam,Sarubala.R.Thondaiman,AMMK,3448,39,3487,240240,310744,19915
139,Srirangam,NOTA,NOTA,2391,26,2417,240240,310744,19915
139,Srirangam,S.Francis Mery,Indiya Jananayaka Katchi,1062,5,1067,240240,310744,19915
139,Srirangam,G.Selvakumar,BSP,805,6,811,240240,310744,19915
139,Srirangam,Annalakshmi,Desiya Makkal Sakthi Katchi,606,2,608,240240,310744,19915
139,Srirangam,V.Sethumadhavan,IND,594,0,594,240240,310744,19915
139,Srirangam,P.Ravichandran,IND,422,1,423,240240,310744,19915
139,Srirangam,S.Suresh,IND,386,2,388,240240,310744,19915
139,Srirangam,Daniel Jude Martin,Makkal Munnetra Peravai,207,3,210,240240,310744,19915
139,Srirangam,R.Uma,IND,157,6,163,240240,310744,19915
139,Srirangam,M.Amsavalli,IND,95,2,97,240240,310744,19915
139,Srirangam,P.Balasubramanian,Samaniya Makkal Nala Katchi,88,1,89,240240,310744,19915
140,Tiruchirappalli (West),"Nehru, K.N.",DMK,116018,2115,118133,183099,268386,85109
140,Tiruchirappalli (West),"Padmanathan, V.",AIADMK,32632,392,33024,183099,268386,85109
140,Tiruchirappalli (West),"Vinodh, V.",NTK,15637,88,15725,183099,268386,85109
140,Tiruchirappalli (West),"Abubacker Siddiq,  M.",MNM,10466,80,10546,183099,268386,85109
140,Tiruchirappalli (West),"Abdullah Hassan Faizy, R.",SOCIAL DEMOCRATIC PARTY OF INDIA,2525,20,2545,183099,268386,85109
140,Tiruchirappalli (West),NOTA,NOTA,2079,38,2117,183099,268386,85109
140,Tiruchirappalli (West),"Sudha, R.",IND,216,6,222,183099,268386,85109
140,Tiruchirappalli (West),"Vasudevan, A.",IND,211,0,211,183099,268386,85109
140,Tiruchirappalli (West),"Kalpana, T.",IND,193,3,196,183099,268386,85109
140,Tiruchirappalli (West),"Shajahan, R.",IND,181,0,181,183099,268386,85109
140,Tiruchirappalli (West),"Dheepan, M.",IND,65,1,66,183099,268386,85109
140,Tiruchirappalli (West),"Selvaraj, D.",IND,48,0,48,183099,268386,85109
140,Tiruchirappalli (West),"Sahabudheen, A.J.",IND,41,2,43,183099,268386,85109
140,Tiruchirappalli (West),"Sundar Rajulu, G.",IND,40,2,42,183099,268386,85109
141,Tiruchirappalli (East),"INIGO IRUDAYARAJ,S.",DMK,92645,1657,94302,172856,254448,53797
141,Tiruchirappalli (East),"VELLAMANDI NATARAJAN,N.",AIADMK,40109,396,40505,172856,254448,53797
141,Tiruchirappalli (East),"PRABU,R.",NTK,14211,101,14312,172856,254448,53797
141,Tiruchirappalli (East),"VEERASAKTHI,D.",MNM,11309,87,11396,172856,254448,53797
141,Tiruchirappalli (East),MANOHARAN.R.,AMMK,9010,79,9089,172856,254448,53797
141,Tiruchirappalli (East),NOTA,NOTA,1504,31,1535,172856,254448,53797
141,Tiruchirappalli (East),"RAJA,S.",IND,381,1,382,172856,254448,53797
141,Tiruchirappalli (East),"BALAMURUGAN,A.",IND,211,0,211,172856,254448,53797
141,Tiruchirappalli (East),"JAHIR HUSSAIN,M.",IND,207,1,208,172856,254448,53797
141,Tiruchirappalli (East),"SHEIK ABDULLAH,R.",IND,199,0,199,172856,254448,53797
141,Tiruchirappalli (East),"MANOHARAN,M.",IND,157,0,157,172856,254448,53797
141,Tiruchirappalli (East),VIJAIA MOHANAAJI,Vidial Valarchi Perani,105,0,105,172856,254448,53797
141,Tiruchirappalli (East),"ARAVINDAN,P.",IND,85,0,85,172856,254448,53797
141,Tiruchirappalli (East),"CHARLES SAGAYARAJ,P.",IND,69,4,73,172856,254448,53797
141,Tiruchirappalli (East),"DEVAKUMAR,T.",IND,72,1,73,172856,254448,53797
141,Tiruchirappalli (East),"AROCKIA SATHEESH,A.",IND,69,1,70,172856,254448,53797
141,Tiruchirappalli (East),"IRUDAYARAJ,S.",IND,55,3,58,172856,254448,53797
141,Tiruchirappalli (East),"GASPAR REGAN,S.",IND,49,1,50,172856,254448,53797
141,Tiruchirappalli (East),"MARUTHAMUTHU,N.",IND,45,1,46,172856,254448,53797
142,Thiruverumbur,ANBIL MAHESH POYYAMOZHI,DMK,103673,1751,105424,197013,291899,49697
142,Thiruverumbur,P KUMAR,AIADMK,55309,418,55727,197013,291899,49697
142,Thiruverumbur,V CHOLASOORAN,NTK,15628,91,15719,197013,291899,49697
142,Thiruverumbur,MURUGANANDAM M,MNM,14547,131,14678,197013,291899,49697
142,Thiruverumbur,S.  SENTHILKUMAR,DMDK,2260,33,2293,197013,291899,49697
142,Thiruverumbur,NOTA,NOTA,1403,15,1418,197013,291899,49697
142,Thiruverumbur,S.SAKTHIVEL,New Generation People’s Party,414,2,416,197013,291899,49697
142,Thiruverumbur,K.M. KARTHIK,Tamil Nadu Ilangyar Katchi,408,5,413,197013,291899,49697
142,Thiruverumbur,MALATHI RAVICHANDRAN,BSP,225,1,226,197013,291899,49697
142,Thiruverumbur,JESTIN RAJA,IND,222,2,224,197013,291899,49697
142,Thiruverumbur,K. PALANISAMY,Veerath Thiyagi Viswanathadoss Thozhilalarkal Katchi,122,1,123,197013,291899,49697
142,Thiruverumbur,N. RAJU,IND,88,0,88,197013,291899,49697
142,Thiruverumbur,R. PRIYA,IND,72,0,72,197013,291899,49697
142,Thiruverumbur,S CHARLES,IND,68,3,71,197013,291899,49697
142,Thiruverumbur,A. RAJA MOHAMED,IND,67,0,67,197013,291899,49697
142,Thiruverumbur,N. MUNIYANDI,IND,52,2,54,197013,291899,49697
143,Lalgudi,A.SOUNDARAPANDIAN,DMK,83264,1650,84914,174754,217527,16949
143,Lalgudi,D.R.DHARMARAJ,AIADMK,67612,353,67965,174754,217527,16949
143,Lalgudi,I.MALAR TAMIL PRABHA,NTK,16134,114,16248,174754,217527,16949
143,Lalgudi,M.VIJAYAMURTHY,AMMK,2913,28,2941,174754,217527,16949
143,Lalgudi,NOTA,NOTA,1191,9,1200,174754,217527,16949
143,Lalgudi,U.JOHNSON,IND,303,1,304,174754,217527,16949
143,Lalgudi,K.KAMARAJ,Samaniya Makkal Nala Katchi,268,2,270,174754,217527,16949
143,Lalgudi,ANBIL K.THANGAMANI,IND,246,1,247,174754,217527,16949
143,Lalgudi,R.SILAMBARASAN,Anna MGR Dravida Makkal Kalgam,138,0,138,174754,217527,16949
143,Lalgudi,P.NAMBIRAJAN,PT,123,1,124,174754,217527,16949
143,Lalgudi,K.DHARMARAJ,IND,120,0,120,174754,217527,16949
143,Lalgudi,A.ANANDHKUMAR,IND,92,4,96,174754,217527,16949
143,Lalgudi,VEERAN.MUTHUKUMAR,Shiv Sena,64,1,65,174754,217527,16949
143,Lalgudi,P.M.SAHADEVAN,IND,65,0,65,174754,217527,16949
143,Lalgudi,K.ANANTHABABU,IND,56,1,57,174754,217527,16949
144,Manachanallur,S. KATHIRAVAN,DMK,114451,1883,116334,196719,243274,59618
144,Manachanallur,M. PARANJOTHI,AIADMK,56366,350,56716,196719,243274,59618
144,Manachanallur,Dr. KRISHNASAMY. V,NTK,14361,82,14443,196719,243274,59618
144,Manachanallur,R. SAMSON,MNM,1975,21,1996,196719,243274,59618
144,Manachanallur,M. RAJASEKHARN,AMMK,1619,12,1631,196719,243274,59618
144,Manachanallur,NOTA,NOTA,1055,12,1067,196719,243274,59618
144,Manachanallur,V.M. SELVARAJ,IND,576,1,577,196719,243274,59618
144,Manachanallur,P. RAJARAM,IND,482,0,482,196719,243274,59618
144,Manachanallur,V. INDIRANI,BSP,448,3,451,196719,243274,59618
144,Manachanallur,C. ARULMANI,Akila India Vallalar Peravai,379,0,379,196719,243274,59618
144,Manachanallur,T. RENGARAJ,Tamil Nadu Ilangyar Katchi,240,0,240,196719,243274,59618
144,Manachanallur,K.R.ELAIYARAJA,IND,237,0,237,196719,243274,59618
144,Manachanallur,V. RAJU,IND,230,1,231,196719,243274,59618
144,Manachanallur,V. GOPALAKRISHNAN,IND,206,0,206,196719,243274,59618
144,Manachanallur,P. NEELAMEGAM,IND,192,0,192,196719,243274,59618
144,Manachanallur,S. PUGAZHENTHI,IND,166,2,168,196719,243274,59618
144,Manachanallur,R. SUDHA,IND,158,3,161,196719,243274,59618
144,Manachanallur,M. DHINAKARAN,PT,155,3,158,196719,243274,59618
144,Manachanallur,R. RAJASEHAR,IND,135,2,137,196719,243274,59618
144,Manachanallur,P. JAGADEESAN,My India Party,110,2,112,196719,243274,59618
144,Manachanallur,K. RAJINIKANTH,IND,110,0,110,196719,243274,59618
144,Manachanallur,P. RAMALINGAM,IND,107,2,109,196719,243274,59618
144,Manachanallur,K. GURUNATHAN,Samaniya Makkal Nala Katchi,103,0,103,196719,243274,59618
144,Manachanallur,V. MUTHUSAMY,IND,100,0,100,196719,243274,59618
144,Manachanallur,S. ROHINI,Makkal Munnetra Peravai,89,2,91,196719,243274,59618
144,Manachanallur,N. MOHAN,IND,91,0,91,196719,243274,59618
144,Manachanallur,K. MANIMARABOOPATHI,IND,61,0,61,196719,243274,59618
144,Manachanallur,S. MANOJ KUMAR,IND,55,0,55,196719,243274,59618
144,Manachanallur,A.C. MANOHARAN,IND,43,0,43,196719,243274,59618
144,Manachanallur,P. MACHAVALLAVAN,IND,38,0,38,196719,243274,59618
145,Musiri,N. Thiyagarajan,DMK,88487,2137,90624,179706,232118,26836
145,Musiri,M. Selvarasu,AIADMK,63179,609,63788,179706,232118,26836
145,Musiri,Sridevi Ilangovan,NTK,14207,104,14311,179706,232118,26836
145,Musiri,Kumar.K.S,DMDK,3153,29,3182,179706,232118,26836
145,Musiri,S. Gokul,MNM,2467,32,2499,179706,232118,26836
145,Musiri,NOTA,NOTA,1081,11,1092,179706,232118,26836
145,Musiri,N. Sivakumar,IND,513,0,513,179706,232118,26836
145,Musiri,T. Senthil Kumar,IND,497,0,497,179706,232118,26836
145,Musiri,T. Periyathambi,IND,462,1,463,179706,232118,26836
145,Musiri,V. Bernardshaw,BSP,458,0,458,179706,232118,26836
145,Musiri,Shanmugam,IND,361,2,363,179706,232118,26836
145,Musiri,N. Saminathan,IND,313,4,317,179706,232118,26836
145,Musiri,R. Michael,IND,297,0,297,179706,232118,26836
145,Musiri,Gautham. S,Rashtriya Samaj Paksha,251,2,253,179706,232118,26836
145,Musiri,Devanur Karthick,IND,227,0,227,179706,232118,26836
145,Musiri,"A.Chandran. M.Sc.,",IND,174,1,175,179706,232118,26836
145,Musiri,V. Natarajan,IND,164,0,164,179706,232118,26836
145,Musiri,"P. Loganathan. M.sc.,",IND,160,1,161,179706,232118,26836
145,Musiri,D. Dharmalingam,Samaniya Makkal Nala Katchi,109,1,110,179706,232118,26836
145,Musiri,N. Aravan,IND,108,0,108,179706,232118,26836
145,Musiri,R. Anandhan,IND,103,1,104,179706,232118,26836
146,Thuraiyur,S.STALINKUMAR,DMK,85802,1984,87786,175876,225547,22071
146,Thuraiyur,T.INDRAGANDHI,AIADMK,65257,458,65715,175876,225547,22071
146,Thuraiyur,R.TAMILZHSELVI,NTK,13074,84,13158,175876,225547,22071
146,Thuraiyur,T.N. YUVARAJAN,MNM,2489,39,2528,175876,225547,22071
146,Thuraiyur,K.SUBRAMANIAN,AMMK,2404,31,2435,175876,225547,22071
146,Thuraiyur,NOTA,NOTA,1580,14,1594,175876,225547,22071
146,Thuraiyur,S.ESWARAMOORTHY,BSP,865,2,867,175876,225547,22071
146,Thuraiyur,K.GUNASEKARAN,PT,539,2,541,175876,225547,22071
146,Thuraiyur,S.KARUPPIAH,IND,314,6,320,175876,225547,22071
146,Thuraiyur,SRINIVASAN J,IND,316,1,317,175876,225547,22071
146,Thuraiyur,K.SUNDARRAJ,IND,230,0,230,175876,225547,22071
146,Thuraiyur,K.JAYAKKANNAN,Tamizhaga Murpokku Makkal Katchi,164,2,166,175876,225547,22071
146,Thuraiyur,A.SEERANGAN,IND,119,0,119,175876,225547,22071
146,Thuraiyur,M.MALARMANNAN,Samaniya Makkal Nala Katchi,100,0,100,175876,225547,22071
147,Perambalur,"PRABHAHARAN, M.",DMK,119636,2454,122090,240026,302294,31034
147,Perambalur,"THAMIZHSELVAN, R.",AIADMK,90325,731,91056,240026,302294,31034
147,Perambalur,"MAHESHWARI, M.",NTK,18592,81,18673,240026,302294,31034
147,Perambalur,"RAJENDRAN, K.",DMDK,2918,14,2932,240026,302294,31034
147,Perambalur,NOTA,NOTA,1867,17,1884,240026,302294,31034
147,Perambalur,"SASIKALA, M.",Indiya Jananayaka Katchi,1073,7,1080,240026,302294,31034
147,Perambalur,"RADHIKA, T.",PT,994,9,1003,240026,302294,31034
147,Perambalur,"RAJENDRAN, K.",BSP,519,1,520,240026,302294,31034
147,Perambalur,"GUNASEKARAN, A.",Nationalist Congress Party,405,4,409,240026,302294,31034
147,Perambalur,"SATHISH, S.",IND,379,0,379,240026,302294,31034
148,Kunnam,"SIVASANKAR, S.S.",DMK,102707,1215,103922,219879,273696,6329
148,Kunnam,"RAMACHANDRAN, R.T.",AIADMK,96734,859,97593,219879,273696,6329
148,Kunnam,"ARUL, P.",NTK,9319,35,9354,219879,273696,6329
148,Kunnam,"KAARTHIKEYAN, S.",AMMK,2092,26,2118,219879,273696,6329
148,Kunnam,"SELVARAJU, R.",IND,977,0,977,219879,273696,6329
148,Kunnam,"BALAMURUGAN, S.",IND,934,0,934,219879,273696,6329
148,Kunnam,NOTA,NOTA,751,2,753,219879,273696,6329
148,Kunnam,"SATHIK BASHA, A.S.",MNM,731,8,739,219879,273696,6329
148,Kunnam,"PRAKASH, M.R.",IND,604,0,604,219879,273696,6329
148,Kunnam,"PANDIYAN, S.",BSP,494,0,494,219879,273696,6329
148,Kunnam,"VINOTHKUMAR, M.",IND,451,0,451,219879,273696,6329
148,Kunnam,"PUGALENTHI, Dr.S.",IND,366,0,366,219879,273696,6329
148,Kunnam,"GOWTHAMAN, V.",IND,331,5,336,219879,273696,6329
148,Kunnam,"SURESHKUMAR, S.",IND,265,4,269,219879,273696,6329
148,Kunnam,"RAVANAN, M.",New Generation People’s Party,183,4,187,219879,273696,6329
148,Kunnam,"SELVAM, J.",IND,174,0,174,219879,273696,6329
148,Kunnam,"MANIKANDAN, K.",IND,152,0,152,219879,273696,6329
148,Kunnam,"ARUL, G.",IND,119,4,123,219879,273696,6329
148,Kunnam,KALAIYARASI SARAVANAN,IND,89,1,90,219879,273696,6329
148,Kunnam,"MATHIYAZHAGAN, S.",IND,86,1,87,219879,273696,6329
148,Kunnam,"KALAISELVI, J.",IND,67,1,68,219879,273696,6329
148,Kunnam,"KATHIRAVAN, C.",IND,47,1,48,219879,273696,6329
148,Kunnam,"MUTHAMILSELVAN, D.",IND,40,0,40,219879,273696,6329
149,Ariyalur,CHINNAPPA K,DMK,102964,1011,103975,225225,264014,3234
149,Ariyalur,RAJENDRAN S,AIADMK,100436,305,100741,225225,264014,3234
149,Ariyalur,SUGUNA KUMAR,NTK,12285,61,12346,225225,264014,3234
149,Ariyalur,DURAI.MANIVEL,AMMK,2040,4,2044,225225,264014,3234
149,Ariyalur,NOTA,NOTA,1383,3,1386,225225,264014,3234
149,Ariyalur,THANGA. SHANMUGA SUNDARAM,New Generation People’s Party,1028,9,1037,225225,264014,3234
149,Ariyalur,JAWAHAR P,Indiya Jananayaka Katchi,896,9,905,225225,264014,3234
149,Ariyalur,RAMESH K,IND,766,1,767,225225,264014,3234
149,Ariyalur,RAVICHANDRAN S,IND,630,2,632,225225,264014,3234
149,Ariyalur,MANIKANNAN M,IND,539,1,540,225225,264014,3234
149,Ariyalur,SAVARIANANDHAM V,BSP,483,3,486,225225,264014,3234
149,Ariyalur,SIVATHASAN V,IND,159,0,159,225225,264014,3234
149,Ariyalur,DEVA P,IND,127,6,133,225225,264014,3234
149,Ariyalur,KUMAR J,IND,73,1,74,225225,264014,3234
150,Jayankondam,KANNAN KA SO KA,DMK,98174,1355,99529,216368,266013,5452
150,Jayankondam,BALU K,PMK,93217,860,94077,216368,266013,5452
150,Jayankondam,MAHALINGAM NEELA,NTK,9903,53,9956,216368,266013,5452
150,Jayankondam,SORNALATHA @ LATHA G,Indiya Jananayaka Katchi,4662,38,4700,216368,266013,5452
150,Jayankondam,NOTA,NOTA,1850,11,1861,216368,266013,5452
150,Jayankondam,SIVA J K,AMMK,1545,15,1560,216368,266013,5452
150,Jayankondam,KESAVARAJAN V K,IND,1543,3,1546,216368,266013,5452
150,Jayankondam,RAJKUMAR S,IND,945,2,947,216368,266013,5452
150,Jayankondam,NEELAMEGAM K,BSP,603,2,605,216368,266013,5452
150,Jayankondam,NATARAJAN A,Anna Dravidar Kazhagam,413,5,418,216368,266013,5452
150,Jayankondam,SATHISHKUMAR R,IND,348,1,349,216368,266013,5452
150,Jayankondam,SAMUVEL MARTIN A,IND,309,3,312,216368,266013,5452
150,Jayankondam,SEDHURAMAN R,IND,257,1,258,216368,266013,5452
150,Jayankondam,SUDARVIZHI K,IND,247,3,250,216368,266013,5452
151,Tittagudi (SC),"GANESAN,  C.V.",DMK,82780,946,83726,168184,218971,21563
151,Tittagudi (SC),"PERIYASAMY,  D.",BJP,61851,312,62163,168184,218971,21563
151,Tittagudi (SC),"KAMATCHI,  N.",NTK,10555,36,10591,168184,218971,21563
151,Tittagudi (SC),"UMANATH,  R.",DMDK,4121,21,4142,168184,218971,21563
151,Tittagudi (SC),"PRABAKARAN,  R.",MNM,1730,15,1745,168184,218971,21563
151,Tittagudi (SC),"NATARAJAN,  M.",IND,1063,0,1063,168184,218971,21563
151,Tittagudi (SC),NOTA,NOTA,995,4,999,168184,218971,21563
151,Tittagudi (SC),"KARUPPAN,  M.",IND,927,17,944,168184,218971,21563
151,Tittagudi (SC),"AYYASAMY,  S.",IND,720,4,724,168184,218971,21563
151,Tittagudi (SC),"PALANIAMMAL,  P.",IND,601,0,601,168184,218971,21563
151,Tittagudi (SC),"RAVICHANDRAN,  P.",BSP,558,1,559,168184,218971,21563
151,Tittagudi (SC),"SUMATHI,  S.",IND,237,1,238,168184,218971,21563
151,Tittagudi (SC),"ARULDOSS,  E.",Desiya Makkal Sakthi Katchi,219,2,221,168184,218971,21563
151,Tittagudi (SC),"SEENUVASAN,  C.",IND,197,0,197,168184,218971,21563
151,Tittagudi (SC),"KAMARAJ,  K.",IND,141,0,141,168184,218971,21563
151,Tittagudi (SC),"KOLANJINATHAN,  V.",IND,129,1,130,168184,218971,21563
152,Vridhachalam,Radhakrishnan,INC,75892,1172,77064,196734,251705,862
152,Vridhachalam,Karthikeyan. J,PMK,75585,617,76202,196734,251705,862
152,Vridhachalam,Premalatha Vijayakant,DMDK,25790,118,25908,196734,251705,862
152,Vridhachalam,N. Amutha,NTK,8603,39,8642,196734,251705,862
152,Vridhachalam,R. Kesavaperumal,Tamil Nadu Ilangyar Katchi,887,4,891,196734,251705,862
152,Vridhachalam,Stalin,IND,859,3,862,196734,251705,862
152,Vridhachalam,R. Parthasarathi,Indiya Jananayaka Katchi,822,19,841,196734,251705,862
152,Vridhachalam,NOTA,NOTA,757,4,761,196734,251705,862
152,Vridhachalam,S. Muruganantham,IND,526,1,527,196734,251705,862
152,Vridhachalam,Perumal,IND,485,0,485,196734,251705,862
152,Vridhachalam,A. Ayyasamy,BSP,461,7,468,196734,251705,862
152,Vridhachalam,B. Arasi,Rashtriya Janata Dal,404,1,405,196734,251705,862
152,Vridhachalam,R. Saravanan,IND,398,0,398,196734,251705,862
152,Vridhachalam,G. Pichamuthu,Desiya Sirupanmayinar Makkal Iyakkam,323,0,323,196734,251705,862
152,Vridhachalam,M. Anwar Basha,IND,298,2,300,196734,251705,862
152,Vridhachalam,Sathiyanathan,Anaithu Makkal Puratchi Katchi,272,1,273,196734,251705,862
152,Vridhachalam,K.P.Senthilmurugan,IND,270,0,270,196734,251705,862
152,Vridhachalam,C. Dhanasekar,IND,268,0,268,196734,251705,862
152,Vridhachalam,M. Sathiyaseelan,IND,261,0,261,196734,251705,862
152,Vridhachalam,S. Sadhasivam,IND,245,1,246,196734,251705,862
152,Vridhachalam,N. Radhika,IND,193,1,194,196734,251705,862
152,Vridhachalam,Sivasankar,New Generation People’s Party,178,1,179,196734,251705,862
152,Vridhachalam,S. Mahaveer Chand,IND,175,0,175,196734,251705,862
152,Vridhachalam,K. Ravichandiran,IND,156,0,156,196734,251705,862
152,Vridhachalam,T. Veeramani,IND,148,0,148,196734,251705,862
152,Vridhachalam,Ramadoss  S,IND,114,1,115,196734,251705,862
152,Vridhachalam,A. Manikandan,IND,108,1,109,196734,251705,862
152,Vridhachalam,S. Radhakrishnan,IND,101,2,103,196734,251705,862
152,Vridhachalam,S. Aruljothi,IND,86,0,86,196734,251705,862
152,Vridhachalam,P. Ramasamy,IND,74,0,74,196734,251705,862
153,Neyveli,SABA.RAJENDRAN,DMK,74189,988,75177,164130,217904,977
153,Neyveli,JAGAN.K,PMK,73544,656,74200,164130,217904,977
153,Neyveli,RAMESH.K,NTK,7763,22,7785,164130,217904,977
153,Neyveli,BAKTHARATCHAGAN.R,AMMK,2221,9,2230,164130,217904,977
153,Neyveli,NOTA,NOTA,1164,7,1171,164130,217904,977
153,Neyveli,ILANGOVAN.R,Indiya Jananayaka Katchi,1006,5,1011,164130,217904,977
153,Neyveli,RAJENDRAN .B,IND,552,4,556,164130,217904,977
153,Neyveli,VADUGANATHAN.R,IND,519,0,519,164130,217904,977
153,Neyveli,KANAGARAJI.C,BSP,450,5,455,164130,217904,977
153,Neyveli,DHILIBAN.U,IND,392,0,392,164130,217904,977
153,Neyveli,DHANASEKARAN.S,IND,333,1,334,164130,217904,977
153,Neyveli,DHURGA.K,IND,204,5,209,164130,217904,977
153,Neyveli,BOOBALAN.E,IND,91,0,91,164130,217904,977
154,Panruti,VELMURUGAN.T,DMK,92917,884,93801,197049,244711,4697
154,Panruti,RAJENDRAN.R,AIADMK,88489,615,89104,197049,244711,4697
154,Panruti,SUBHASHINI.R,NTK,6511,36,6547,197049,244711,4697
154,Panruti,SIVAKOZHUNDU.P,DMDK,3357,5,3362,197049,244711,4697
154,Panruti,JAYLANI,MNM,1657,13,1670,197049,244711,4697
154,Panruti,NOTA,NOTA,1320,3,1323,197049,244711,4697
154,Panruti,VELMURUGAN.K,IND,418,0,418,197049,244711,4697
154,Panruti,ARULKUMAR.R,IND,159,0,159,197049,244711,4697
154,Panruti,VELMURUGAN.R,IND,152,0,152,197049,244711,4697
154,Panruti,PRAKASH.R,IND,125,0,125,197049,244711,4697
154,Panruti,SUMATHI.V,IND,106,10,116,197049,244711,4697
154,Panruti,KAMADEVAN.S,IND,69,0,69,197049,244711,4697
154,Panruti,KRISHNARAJ.S,IND,67,1,68,197049,244711,4697
154,Panruti,KUMAR.D,IND,45,3,48,197049,244711,4697
154,Panruti,NAGAMANI.M,IND,45,0,45,197049,244711,4697
154,Panruti,GOVINDASAMY.S,IND,42,0,42,197049,244711,4697
155,Cuddalore,G.IYAPPAN,DMK,82813,1750,84563,182001,238365,5151
155,Cuddalore,M.C.SAMPATH,AIADMK,78004,1408,79412,182001,238365,5151
155,Cuddalore,JALADEEPAN.V,NTK,9480,83,9563,182001,238365,5151
155,Cuddalore,K.ANANDRAJ,MNM,4005,35,4040,182001,238365,5151
155,Cuddalore,A.GNANAPANDITHAN,DMDK,1489,10,1499,182001,238365,5151
155,Cuddalore,NOTA,NOTA,1228,8,1236,182001,238365,5151
155,Cuddalore,S.PUSHBARAJ,Tamil Nadu Ilangyar Katchi,608,9,617,182001,238365,5151
155,Cuddalore,J.JACOB,IND,307,0,307,182001,238365,5151
155,Cuddalore,S.DEENADHAYALAN,IND,289,2,291,182001,238365,5151
155,Cuddalore,V. DAKSHNAMOORTHY,IND,183,2,185,182001,238365,5151
155,Cuddalore,R.VALLAL KUMAR,BSP,78,1,79,182001,238365,5151
155,Cuddalore,S.V.RAJARAJAN,Desiya Makkal Sakthi Katchi,74,0,74,182001,238365,5151
155,Cuddalore,S.SAMPATH,IND,46,0,46,182001,238365,5151
155,Cuddalore,K.THANGARASU,IND,31,0,31,182001,238365,5151
155,Cuddalore,A.Mohamed Usman,Anna Puratchi Thalaivar Amma Dravida Munnetra Kazhagam,29,0,29,182001,238365,5151
155,Cuddalore,G.KRISHNAN,IND,25,4,29,182001,238365,5151
156,Kurinjipadi,M.R.K.PANNEERSELVAM,DMK,100463,993,101456,198781,242592,17527
156,Kurinjipadi,SELVI RAMAJAYAM,AIADMK,83478,451,83929,198781,242592,17527
156,Kurinjipadi,S.SUMATHI,NTK,8470,42,8512,198781,242592,17527
156,Kurinjipadi,NOTA,NOTA,1208,4,1212,198781,242592,17527
156,Kurinjipadi,K.CHANDRAMOULI,Janata Dal  (Secular),1178,11,1189,198781,242592,17527
156,Kurinjipadi,A.VASANTHAKUMAR,AMMK,834,3,837,198781,242592,17527
156,Kurinjipadi,R.RAJESH,IND,515,0,515,198781,242592,17527
156,Kurinjipadi,T.VELAYUDHAM,BSP,480,2,482,198781,242592,17527
156,Kurinjipadi,R.SARATHKUMAR,IND,154,0,154,198781,242592,17527
156,Kurinjipadi,R.MUTHUKRISHNAN,Anna Dravidar Kazhagam,140,0,140,198781,242592,17527
156,Kurinjipadi,L.MADHIYAZHAGAN,IND,139,0,139,198781,242592,17527
156,Kurinjipadi,N.MUTHAZHAGAN,IND,124,0,124,198781,242592,17527
156,Kurinjipadi,BRIJITA ROSLENE,IND,91,1,92,198781,242592,17527
157,Bhuvanagiri,Arunmozhithevan. A,AIADMK,95536,917,96453,197165,248264,-8259
157,Bhuvanagiri,Saravanan. Durai.K,DMK,87217,977,88194,197165,248264,-8259
157,Bhuvanagiri,Rathinavel. R.,NTK,6927,31,6958,197165,248264,-8259
157,Bhuvanagiri,Balamurugan. K.S.K,AMMK,2464,6,2470,197165,248264,-8259
157,Bhuvanagiri,NOTA,NOTA,1058,0,1058,197165,248264,-8259
157,Bhuvanagiri,Ezhilvendhan. R,BSP,503,1,504,197165,248264,-8259
157,Bhuvanagiri,Ranjith. R,IND,333,0,333,197165,248264,-8259
157,Bhuvanagiri,Revathi. R.,Indiya Jananayaka Katchi,314,1,315,197165,248264,-8259
157,Bhuvanagiri,Saravanan. J.,IND,192,4,196,197165,248264,-8259
157,Bhuvanagiri,Jeyakumar. K,IND,184,0,184,197165,248264,-8259
157,Bhuvanagiri,Pazhanivel. M,IND,141,1,142,197165,248264,-8259
157,Bhuvanagiri,Balamurugan. G.C,IND,132,1,133,197165,248264,-8259
157,Bhuvanagiri,Anandan. S (a) Kavignar Sella Aananthamaalai,IND,102,0,102,197165,248264,-8259
157,Bhuvanagiri,Sivakumari. T,IND,68,0,68,197165,248264,-8259
157,Bhuvanagiri,Ezhilvendan. P.,IND,55,0,55,197165,248264,-8259
158,Chidambaram,K.A. PANDIAN,AIADMK,90523,1438,91961,183352,250740,-16937
158,Chidambaram,S. ABDUL RAHMAN,IUML,73773,1251,75024,183352,250740,-16937
158,Chidambaram,NATARAJAN KRISHNAMOORTHY,NTK,9021,50,9071,183352,250740,-16937
158,Chidambaram,G. DEVASAGAYAM,MNM,2924,29,2953,183352,250740,-16937
158,Chidambaram,M. NANTHINIDEVI,AMMK,1380,8,1388,183352,250740,-16937
158,Chidambaram,NOTA,NOTA,1190,12,1202,183352,250740,-16937
158,Chidambaram,D. CHANDRA PRABU,BSP,474,4,478,183352,250740,-16937
158,Chidambaram,S. BALAMURUGAN,IND,335,2,337,183352,250740,-16937
158,Chidambaram,K. UDAYA SELVAN,Anaithu Makkal Puratchi Katchi,304,1,305,183352,250740,-16937
158,Chidambaram,C. VINOBA,IND,245,0,245,183352,250740,-16937
158,Chidambaram,B. NARAYANAMOORTHY,IND,240,2,242,183352,250740,-16937
158,Chidambaram,M. RAGHUNATHAN,Ilantamilar Munnani Kazhagam,145,1,146,183352,250740,-16937
159,Kattumannarkoil(SC),SINTHANAI SELVAN,VCK,84986,1070,86056,175561,228520,10565
159,Kattumannarkoil(SC),N. MURUGUMARAN,AIADMK,74608,883,75491,175561,228520,10565
159,Kattumannarkoil(SC),P. NIVEDHA,NTK,6762,44,6806,175561,228520,10565
159,Kattumannarkoil(SC),S. NARAYANAMOORTHY,AMMK,1892,12,1904,175561,228520,10565
159,Kattumannarkoil(SC),THANGA VIKRAM,MNM,1391,24,1415,175561,228520,10565
159,Kattumannarkoil(SC),A. ANANDAN,IND,991,0,991,175561,228520,10565
159,Kattumannarkoil(SC),NOTA,NOTA,647,1,648,175561,228520,10565
159,Kattumannarkoil(SC),M.G. KALYANASUNDARAM,All India Jananayaka Makkal Kazhagam,458,2,460,175561,228520,10565
159,Kattumannarkoil(SC),THANGA UDHAYAKUMAR,BSP,425,4,429,175561,228520,10565
159,Kattumannarkoil(SC),M.A.T. ARCHUNAN,IND,417,4,421,175561,228520,10565
159,Kattumannarkoil(SC),P.M. KUMAR,IND,362,1,363,175561,228520,10565
159,Kattumannarkoil(SC),MATHIAZHAGAN,IND,227,0,227,175561,228520,10565
159,Kattumannarkoil(SC),S.TAMILSELVAN,IND,216,0,216,175561,228520,10565
159,Kattumannarkoil(SC),M. THIRUNAVUKARASU,Anna Puratchi Thalaivar Amma Dravida Munnetra Kazhagam,133,1,134,175561,228520,10565
160,Sirkazhi,PANNEERSELVAM,DMK,92866,1191,94057,191325,251783,12148
160,Sirkazhi,P.V.BHARATHI,AIADMK,81235,674,81909,191325,251783,12148
160,Sirkazhi,Kavitha,NTK,10966,47,11013,191325,251783,12148
160,Sirkazhi,BALU,AMMK,1301,7,1308,191325,251783,12148
160,Sirkazhi,PRABU,MNM,990,10,1000,191325,251783,12148
160,Sirkazhi,NOTA,NOTA,974,3,977,191325,251783,12148
160,Sirkazhi,SRITHAR,BSP,490,5,495,191325,251783,12148
160,Sirkazhi,BARATHI,IND,287,1,288,191325,251783,12148
160,Sirkazhi,Silambarasan,IND,121,1,122,191325,251783,12148
160,Sirkazhi,Kamban,Anaithu Makkal Arasiyal Katchi,76,3,79,191325,251783,12148
160,Sirkazhi,ANUSUYA,IND,76,1,77,191325,251783,12148
161,Mayiladuthurai,Rajakumar.S,INC,72376,1266,73642,174640,245028,2742
161,Mayiladuthurai,Palanisamy.A,PMK,70310,590,70900,174640,245028,2742
161,Mayiladuthurai,Kasiraman.K,NTK,13123,63,13186,174640,245028,2742
161,Mayiladuthurai,Anbarasan Komal R K,AMMK,7205,77,7282,174640,245028,2742
161,Mayiladuthurai,Ravichandran.N,MNM,5850,83,5933,174640,245028,2742
161,Mayiladuthurai,NOTA,NOTA,1054,13,1067,174640,245028,2742
161,Mayiladuthurai,Rajkumar.S,Tamil Nadu Ilangyar Katchi,645,6,651,174640,245028,2742
161,Mayiladuthurai,Shamsudeen.N,BSP,523,3,526,174640,245028,2742
161,Mayiladuthurai,Rajendran.M,IND,356,0,356,174640,245028,2742
161,Mayiladuthurai,Niranjan.R,IND,242,1,243,174640,245028,2742
161,Mayiladuthurai,Manimaran.T,IND,206,2,208,174640,245028,2742
161,Mayiladuthurai,Ganesan.S,IND,185,0,185,174640,245028,2742
161,Mayiladuthurai,Babusankar.R,IND,167,1,168,174640,245028,2742
161,Mayiladuthurai,Loga.Sampath,IND,152,3,155,174640,245028,2742
161,Mayiladuthurai,Thimothy.T,IND,135,3,138,174640,245028,2742
162,Poompuhar,Nivedha M. Murugan,DMK,95161,941,96102,207838,275585,3299
162,Poompuhar,S.Pavunraj,AIADMK,92299,504,92803,207838,275585,3299
162,Poompuhar,P. Kaliyammal,NTK,14783,40,14823,207838,275585,3299
162,Poompuhar,S.Senthamizhan,AMMK,1212,8,1220,207838,275585,3299
162,Poompuhar,M.H.Meharajdeen,MNM,946,4,950,207838,275585,3299
162,Poompuhar,NOTA,NOTA,727,6,733,207838,275585,3299
162,Poompuhar,T. Ilanchezhian,BSP,496,4,500,207838,275585,3299
162,Poompuhar,S.Pandiyarajan,IND,343,0,343,207838,275585,3299
162,Poompuhar,S.Murugan,IND,261,1,262,207838,275585,3299
162,Poompuhar,A. Kalaivanan,IND,102,0,102,207838,275585,3299
163,Nagapattinam,J. Mohamed Shanavas,VCK,65587,694,66281,143560,197326,7238
163,Nagapattinam,Thanka.kathiravan,AIADMK,58729,314,59043,143560,197326,7238
163,Nagapattinam,S.Augustine Arputharaj,NTK,9931,45,9976,143560,197326,7238
163,Nagapattinam,C.Manjula,AMMK,3457,46,3503,143560,197326,7238
163,Nagapattinam,Syed Anas Mohideen Sahip,MNM,2523,17,2540,143560,197326,7238
163,Nagapattinam,NOTA,NOTA,893,2,895,143560,197326,7238
163,Nagapattinam,Mayilarasi,Naadaalum Makkal Katchi,256,0,256,143560,197326,7238
163,Nagapattinam,V. Manikandan,IND,252,0,252,143560,197326,7238
163,Nagapattinam,V. Canagaradjou,IND,208,1,209,143560,197326,7238
163,Nagapattinam,N P Bhashgaran,IND,180,4,184,143560,197326,7238
163,Nagapattinam,Durai. Selvakumar,IND,110,3,113,143560,197326,7238
163,Nagapattinam,T. Singaravadivelan,Shiv Sena,105,0,105,143560,197326,7238
163,Nagapattinam,S. Prem,IND,105,0,105,143560,197326,7238
163,Nagapattinam,J.V. Durai,Makkalatchi Katchi,96,2,98,143560,197326,7238
164,Kilvelur,NAGAIMAALI V P,CPM,67288,700,67988,142995,179266,16985
164,Kilvelur,VADIVEL RAVANAN  S,PMK,50754,249,51003,142995,179266,16985
164,Kilvelur,PONELAVAZHAKI  S,NTK,15088,85,15173,142995,179266,16985
164,Kilvelur,SIDHU G,MNM,2890,16,2906,142995,179266,16985
164,Kilvelur,NEETHIMOHAN M,AMMK,2494,9,2503,142995,179266,16985
164,Kilvelur,NOTA,NOTA,895,2,897,142995,179266,16985
164,Kilvelur,TAMILARASAN U,BSP,636,5,641,142995,179266,16985
164,Kilvelur,KALAISELVAN G,IND,613,2,615,142995,179266,16985
164,Kilvelur,MUTHALAGAN S,PT,614,0,614,142995,179266,16985
164,Kilvelur,VEDHA MUKUNDHAN,IND,481,1,482,142995,179266,16985
164,Kilvelur,MARUTHAIYAN G,IND,171,2,173,142995,179266,16985
165,Vedaranyam,O.S.MANIAN,AIADMK,77625,1094,78719,158060,192342,-12329
165,Vedaranyam,S.K.VETHARATHINAM,DMK,64823,1567,66390,158060,192342,-12329
165,Vedaranyam,K.RAJENDRAN,NTK,9030,76,9106,158060,192342,-12329
165,Vedaranyam,P.S.ARUMUGAM,AMMK,1276,8,1284,158060,192342,-12329
165,Vedaranyam,NOTA,NOTA,670,3,673,158060,192342,-12329
165,Vedaranyam,R.PANNEERSELVAM,BSP,460,0,460,158060,192342,-12329
165,Vedaranyam,MOHAMED ALI,MNM,433,4,437,158060,192342,-12329
165,Vedaranyam,P.V.THEENATHAYALAN,IND,315,4,319,158060,192342,-12329
165,Vedaranyam,V.VEERAKUMAR,IND,297,0,297,158060,192342,-12329
165,Vedaranyam,R.KATHIRVEL,IND,139,4,143,158060,192342,-12329
165,Vedaranyam,Dr.T.SUNDARAVADIVELAN,Shiv Sena,91,0,91,158060,192342,-12329
165,Vedaranyam,T.RAMAJAYAM,IND,63,13,76,158060,192342,-12329
165,Vedaranyam,R.RAMAMURTHY,IND,65,0,65,158060,192342,-12329
166,Thiruthuraipoondi,MARIMUTHU K,CPI,95785,1307,97092,185886,239138,30068
166,Thiruthuraipoondi,SURESH KUMAR C,AIADMK,66683,341,67024,185886,239138,30068
166,Thiruthuraipoondi,AARTHI A,NTK,15300,62,15362,185886,239138,30068
166,Thiruthuraipoondi,RAJANIKANTH S,AMMK,3536,19,3555,185886,239138,30068
166,Thiruthuraipoondi,NOTA,NOTA,1310,3,1313,185886,239138,30068
166,Thiruthuraipoondi,PARAMASIVAM K,IND,476,0,476,185886,239138,30068
166,Thiruthuraipoondi,PARIVENTHAN D,All India Samathuva Makhal Katchi,313,2,315,185886,239138,30068
166,Thiruthuraipoondi,SURESH A K,IND,184,6,190,185886,239138,30068
166,Thiruthuraipoondi,THULASIRAMAN R,IND,155,0,155,185886,239138,30068
166,Thiruthuraipoondi,THIRUVARUL SELVI V,IND,138,1,139,185886,239138,30068
166,Thiruthuraipoondi,SENGUTTUVAN M,IND,133,3,136,185886,239138,30068
166,Thiruthuraipoondi,SIVAPRAKASAM V,IND,128,1,129,185886,239138,30068
167,Mannargudi,RAJAA T R B,DMK,86071,1101,87172,193229,258433,37393
167,Mannargudi,RAJAMANICKAM  SIVA,AIADMK,49570,209,49779,193229,258433,37393
167,Mannargudi,KAMARAJ S,AMMK,40271,210,40481,193229,258433,37393
167,Mannargudi,ARAVINDAN RAMA,NTK,10398,40,10438,193229,258433,37393
167,Mannargudi,KUMARESAN T,IND,1837,8,1845,193229,258433,37393
167,Mannargudi,ANBANANDAM S,MNM,1358,8,1366,193229,258433,37393
167,Mannargudi,NOTA,NOTA,955,5,960,193229,258433,37393
167,Mannargudi,SATHISKUMAR S,PT,584,4,588,193229,258433,37393
167,Mannargudi,MURUGAN S,IND,376,2,378,193229,258433,37393
167,Mannargudi,MARIMUTHU A.V.M,IND,124,1,125,193229,258433,37393
167,Mannargudi,BARADHIDASAN T,IND,95,2,97,193229,258433,37393
168,Thiruvarur,KALAIVANAN  POONDI  K.,DMK,107540,1366,108906,208290,281541,51174
168,Thiruvarur,PANNERSELVAM A.N.R.,AIADMK,57439,293,57732,208290,281541,51174
168,Thiruvarur,VINOTHINI R.,NTK,26211,89,26300,208290,281541,51174
168,Thiruvarur,NASEEMA BANU M.A.,SOCIAL DEMOCRATIC PARTY OF INDIA,6348,16,6364,208290,281541,51174
168,Thiruvarur,KABILARASAN  P.,MNM,4034,34,4068,208290,281541,51174
168,Thiruvarur,NOTA,NOTA,1646,7,1653,208290,281541,51174
168,Thiruvarur,THIYAGASUNDARAM N.,Tamil Nadu Ilangyar Katchi,1000,8,1008,208290,281541,51174
168,Thiruvarur,GOMATHI A.,BSP,716,4,720,208290,281541,51174
168,Thiruvarur,PANNEERSELVAM J.,IND,530,1,531,208290,281541,51174
168,Thiruvarur,THIYAGARAJAN  M.,PT,285,8,293,208290,281541,51174
168,Thiruvarur,MOHAMED HALITH A.,IND,247,0,247,208290,281541,51174
168,Thiruvarur,MUTHARASAN S.,IND,200,2,202,208290,281541,51174
168,Thiruvarur,AMANULLAH R.S.A.,IND,163,0,163,208290,281541,51174
168,Thiruvarur,ANBAZHAGAN T.,IND,101,2,103,208290,281541,51174
169,Nannilam,KAMARAJ R,AIADMK,103236,401,103637,221944,271473,-4424
169,Nannilam,JOTHIRAMAN  S,DMK,98409,804,99213,221944,271473,-4424
169,Nannilam,FATHIMA FARHANA  S,NTK,13377,42,13419,221944,271473,-4424
169,Nannilam,RAMACHANDRAN   N,AMMK,2070,6,2076,221944,271473,-4424
169,Nannilam,NOTA,NOTA,1188,2,1190,221944,271473,-4424
169,Nannilam,RAVICHANDRAN  R,BSP,711,0,711,221944,271473,-4424
169,Nannilam,GANESAN  D,Indiya Jananayaka Katchi,379,2,381,221944,271473,-4424
169,Nannilam,NATARAJAN  C,IND,352,0,352,221944,271473,-4424
169,Nannilam,ANUSHA  T,IND,203,3,206,221944,271473,-4424
169,Nannilam,MURUGAVEL  M,Anna Dravidar Kazhagam,163,1,164,221944,271473,-4424
169,Nannilam,TAMILSELVAN  R,IND,153,0,153,221944,271473,-4424
169,Nannilam,RAJA S,IND,125,0,125,221944,271473,-4424
169,Nannilam,PANASAIARAGAN K N,Desiya Makkal Sakthi Katchi,111,0,111,221944,271473,-4424
169,Nannilam,NITHIYANANTHAM  S,Anaithu Makkal Arasiyal Katchi,81,0,81,221944,271473,-4424
169,Nannilam,KUMARAN  R,IND,77,1,78,221944,271473,-4424
169,Nannilam,KRISHNAN  K,IND,46,1,47,221944,271473,-4424
170,Thiruvidaimarudur,"CHEZHIAAN,  GOVI.",DMK,94602,1161,95763,198446,259077,10680
170,Thiruvidaimarudur,"UNION VEERAMANI, S.",AIADMK,84703,380,85083,198446,259077,10680
170,Thiruvidaimarudur,"DIVYA BHARATHI, M.",NTK,11147,29,11176,198446,259077,10680
170,Thiruvidaimarudur,"PURATCHI MANI, M.",BSP,1825,14,1839,198446,259077,10680
170,Thiruvidaimarudur,"KUDANTHAI ARASAN, J.",AMMK,1736,10,1746,198446,259077,10680
170,Thiruvidaimarudur,NOTA,NOTA,1233,7,1240,198446,259077,10680
170,Thiruvidaimarudur,"KANNAIYAN, T.",CPI(ML)(L),574,2,576,198446,259077,10680
170,Thiruvidaimarudur,"MARIMUTHU, G.",IND,245,0,245,198446,259077,10680
170,Thiruvidaimarudur,"MADHANKUMAR, R.",Indiya Jananayaka Katchi,222,4,226,198446,259077,10680
170,Thiruvidaimarudur,"MARIYAPPAN, N.",IND,198,0,198,198446,259077,10680
170,Thiruvidaimarudur,"MATHI, M.",IND,102,0,102,198446,259077,10680
170,Thiruvidaimarudur,"SURESH, R.",Anaithu Makkal Puratchi Katchi,78,0,78,198446,259077,10680
170,Thiruvidaimarudur,"KANNAIYAN, N.",IND,62,6,68,198446,259077,10680
170,Thiruvidaimarudur,"NEDUMARAN, S.",IND,66,2,68,198446,259077,10680
170,Thiruvidaimarudur,"DHANASEKAR, V.",IND,38,0,38,198446,259077,10680
171,Kumbakonam,"ANBALAGAN, G.",DMK,94284,1773,96057,197564,272509,21383
171,Kumbakonam,"SRITHAR VANDAYAR, G.M.",AIADMK,74334,340,74674,197564,272509,21383
171,Kumbakonam,"ANANDH, M.",NTK,12419,61,12480,197564,272509,21383
171,Kumbakonam,"BALAMURUGAN, S.",AMMK,6475,48,6523,197564,272509,21383
171,Kumbakonam,"GOPALAKRISHNAN, G.",MNM,5234,42,5276,197564,272509,21383
171,Kumbakonam,NOTA,NOTA,1623,25,1648,197564,272509,21383
171,Kumbakonam,"GURUMOORTHI, D.",IND,229,5,234,197564,272509,21383
171,Kumbakonam,"AYYAPPAN, M.",IND,208,1,209,197564,272509,21383
171,Kumbakonam,"VIJAYAKUMAR, C.",IND,190,0,190,197564,272509,21383
171,Kumbakonam,"SUBRAMANIAN, P.",IND,151,2,153,197564,272509,21383
171,Kumbakonam,"PRAKASH, P.",IND,119,1,120,197564,272509,21383
172,Papanasam,"Dr.JAWAHIRULLAH, M.H.",DMK,85401,1166,86567,196982,260343,16273
172,Papanasam,"GOPINATHAN, K.",AIADMK,69809,485,70294,196982,260343,16273
172,Papanasam,"RENGASAMY, M.",AMMK,19593,185,19778,196982,260343,16273
172,Papanasam,"KRISHNAKUMAR, N.",NTK,14645,79,14724,196982,260343,16273
172,Papanasam,"SHANTHA, K.",MNM,2010,22,2032,196982,260343,16273
172,Papanasam,NOTA,NOTA,1190,14,1204,196982,260343,16273
172,Papanasam,"GOPINATHAN, R.",IND,559,8,567,196982,260343,16273
172,Papanasam,"RAJA, A.",IND,474,3,477,196982,260343,16273
172,Papanasam,"RAJA, A.M.",IND,411,1,412,196982,260343,16273
172,Papanasam,"MUTHUKUMAR, R.",Anaithu Makkal Puratchi Katchi,251,1,252,196982,260343,16273
172,Papanasam,"GOPI, N.",IND,200,11,211,196982,260343,16273
172,Papanasam,"MEHRAJ BANU, N.",All India Jananayaka Makkal Kazhagam,166,3,169,196982,260343,16273
172,Papanasam,"XAVIER, S.",IND,159,4,163,196982,260343,16273
172,Papanasam,"THIYAGARAJAN, V.",IND,130,2,132,196982,260343,16273
173,Thiruvaiyaru,DURAI.CHANDRASEKARAN,DMK,101959,1251,103210,211430,267007,53650
173,Thiruvaiyaru,"VENKATESAN, S.",BJP,49284,276,49560,211430,267007,53650
173,Thiruvaiyaru,"KARTHIKEYAN, V.",AMMK,37310,159,37469,211430,267007,53650
173,Thiruvaiyaru,"SENTHILNATHAN, D.",NTK,15727,93,15820,211430,267007,53650
173,Thiruvaiyaru,"UTHIRAPATHI, G.",PT,1197,18,1215,211430,267007,53650
173,Thiruvaiyaru,NOTA,NOTA,1173,7,1180,211430,267007,53650
173,Thiruvaiyaru,"THIRUMARAN, P.S.",IND,1089,4,1093,211430,267007,53650
173,Thiruvaiyaru,ASWIN,BSP,530,0,530,211430,267007,53650
173,Thiruvaiyaru,"RAJKUMAR, R.",IND,367,1,368,211430,267007,53650
173,Thiruvaiyaru,"VIJAYAKUMAR, S.",Anna Puratchi Thalaivar Amma Dravida Munnetra Kazhagam,255,2,257,211430,267007,53650
173,Thiruvaiyaru,"BACKIYARAJ, V.",Anaithu Makkal Arasiyal Katchi,252,0,252,211430,267007,53650
173,Thiruvaiyaru,"SINGARAVADIVEL, S.",IND,238,2,240,211430,267007,53650
173,Thiruvaiyaru,"SIVARAMAN, T.","Makkal Sananayaga Kudiyarasu Katchi,",236,0,236,211430,267007,53650
174,Thanjavur,"NEELAMEGAM, T.K.G.",DMK,100786,2986,103772,194859,288911,47149
174,Thanjavur,"ARIVUDAINAMBI, V.",AIADMK,56173,450,56623,194859,288911,47149
174,Thanjavur,"SUBADEVI, R.",NTK,17220,146,17366,194859,288911,47149
174,Thanjavur,"SUNDARAMOHAN, G.",MNM,9600,81,9681,194859,288911,47149
174,Thanjavur,"DR.RAMANATHAN, P.",DMDK,4190,56,4246,194859,288911,47149
174,Thanjavur,NOTA,NOTA,1915,23,1938,194859,288911,47149
174,Thanjavur,"KARIKALA CHOLAN, S.",Nationalist Congress Party,274,7,281,194859,288911,47149
174,Thanjavur,"VASUKI, N.",IND,256,4,260,194859,288911,47149
174,Thanjavur,"XAVIER, A.",People's Party of India(secular),214,3,217,194859,288911,47149
174,Thanjavur,"DINESH BABU, D.",IND,141,1,142,194859,288911,47149
174,Thanjavur,"SANTHOSH, M.",IND,119,3,122,194859,288911,47149
174,Thanjavur,"BHARATH, B.",IND,105,5,110,194859,288911,47149
174,Thanjavur,"SABTHAGIRI, R.",IND,100,1,101,194859,288911,47149
175,Orathanadu,"VAITHILINGAM, R.",AIADMK,89516,547,90063,191840,243014,-28835
175,Orathanadu,"RAMCHANDRAN, M.",DMK,60471,757,61228,191840,243014,-28835
175,Orathanadu,"SEKAR, M.",AMMK,25854,168,26022,191840,243014,-28835
175,Orathanadu,"KANDHASAMY, M.",NTK,9013,37,9050,191840,243014,-28835
175,Orathanadu,"MOOKKAIYAN, V.",IND,2031,10,2041,191840,243014,-28835
175,Orathanadu,NOTA,NOTA,861,6,867,191840,243014,-28835
175,Orathanadu,"RENGASAMY, G.",MNM,709,12,721,191840,243014,-28835
175,Orathanadu,"STALIN, R.",BSP,550,0,550,191840,243014,-28835
175,Orathanadu,"JAYASOORIYAN, T.",IND,428,0,428,191840,243014,-28835
175,Orathanadu,"RENGARAJ, S.",IND,317,2,319,191840,243014,-28835
175,Orathanadu,"THANRAJ, R.",United States of India Party,229,0,229,191840,243014,-28835
175,Orathanadu,"ARUNKUMAR, K.",IND,220,3,223,191840,243014,-28835
175,Orathanadu,"PRABAKARAN, U.",Anaithu Makkal Puratchi Katchi,99,0,99,191840,243014,-28835
176,Pattukkottai,"ANNADURAI, K.",DMK,78060,1005,79065,177200,244565,25269
176,Pattukkottai,"RENGARAJAN, N.R.",AIADMK,53521,275,53796,177200,244565,25269
176,Pattukkottai,"BALAKRISHNAN, V.",IND,23704,67,23771,177200,244565,25269
176,Pattukkottai,KEERTHIKA ANBU,NTK,10694,36,10730,177200,244565,25269
176,Pattukkottai,"SELVAM, S.D.S.",AMMK,5191,32,5223,177200,244565,25269
176,Pattukkottai,"SADASIVAM, B.",MNM,3070,18,3088,177200,244565,25269
176,Pattukkottai,NOTA,NOTA,1019,7,1026,177200,244565,25269
176,Pattukkottai,"MEIKKAPPAN, T.",Anna Dravidar Kazhagam,322,0,322,177200,244565,25269
176,Pattukkottai,"SUNDARRAJ, M.",Anaithu Makkal Puratchi Katchi,178,1,179,177200,244565,25269
177,Peravurani,"ASHOKKUMAR, N.",DMK,88102,1028,89130,170850,219664,23503
177,Peravurani,"THIRUGNANASAMBANDAM, S.V.",AIADMK,65395,232,65627,170850,219664,23503
177,Peravurani,"DELIPAN, K.",NTK,12109,45,12154,170850,219664,23503
177,Peravurani,"SIVAKUMAR, M.",DMDK,1618,5,1623,170850,219664,23503
177,Peravurani,NOTA,NOTA,768,2,770,170850,219664,23503
177,Peravurani,"PACHAMUTHU, P.",Indiya Jananayaka Katchi,552,2,554,170850,219664,23503
177,Peravurani,"DURAIRAJ, G.",BSP,493,1,494,170850,219664,23503
177,Peravurani,"UTHAYAKUMAR, U.",IND,260,2,262,170850,219664,23503
177,Peravurani,"ELANGOVAN, G.",IND,236,0,236,170850,219664,23503
178,Gandharvakottai,M.Chinnadurai,CPM,68715,995,69710,157620,201072,12721
178,Gandharvakottai,S.Jayabharathi,AIADMK,56681,308,56989,157620,201072,12721
178,Gandharvakottai,P.Lenin,AMMK,12728,112,12840,157620,201072,12721
178,Gandharvakottai,M.Ramila,NTK,12606,55,12661,157620,201072,12721
178,Gandharvakottai,NOTA,NOTA,1384,6,1390,157620,201072,12721
178,Gandharvakottai,P.Asaithambi,CPI(ML)(L),1260,11,1271,157620,201072,12721
178,Gandharvakottai,KRM.Adhidravidar,MNM,843,5,848,157620,201072,12721
178,Gandharvakottai,V.Rethinam,IND,620,0,620,157620,201072,12721
178,Gandharvakottai,P.Karthikeyan,IND,286,3,289,157620,201072,12721
178,Gandharvakottai,K. Manimuthu,IND,231,1,232,157620,201072,12721
178,Gandharvakottai,P.Rengasamy,IND,206,0,206,157620,201072,12721
178,Gandharvakottai,S.Malarvizhi,Anaithu Makkal Arasiyal Katchi,188,2,190,157620,201072,12721
178,Gandharvakottai,M.Thanaraj,Namadhu Makkal Katchi,133,0,133,157620,201072,12721
178,Gandharvakottai,V.Ilaiyaraja,IND,129,1,130,157620,201072,12721
178,Gandharvakottai,Keerai.A.T.Chinnappa,IND,109,2,111,157620,201072,12721
179,Viralimalai,VIJAYA BASKER C,AIADMK,101676,503,102179,193423,224564,-23598
179,Viralimalai,PALANIAPPAN,DMK,78028,553,78581,193423,224564,-23598
179,Viralimalai,AZHAGU MEENA P,NTK,7013,22,7035,193423,224564,-23598
179,Viralimalai,KARTHI PRABHAKARAN O,AMMK,1220,8,1228,193423,224564,-23598
179,Viralimalai,DHANALAKSHMI.M,IND,618,2,620,193423,224564,-23598
179,Viralimalai,SARAVANAN R,MNM,559,0,559,193423,224564,-23598
179,Viralimalai,THIRUVENTHIRAN V,IND,508,1,509,193423,224564,-23598
179,Viralimalai,RAMESH M,IND,504,0,504,193423,224564,-23598
179,Viralimalai,NOTA,NOTA,385,0,385,193423,224564,-23598
179,Viralimalai,MANIKANDAN. C,IND,291,0,291,193423,224564,-23598
179,Viralimalai,ALAGURAJA.V,BSP,263,0,263,193423,224564,-23598
179,Viralimalai,PALANISAMY A,IND,239,2,241,193423,224564,-23598
179,Viralimalai,ARUMUGAM P,PT,213,2,215,193423,224564,-23598
179,Viralimalai,JOTHIVEL A,IND,191,0,191,193423,224564,-23598
179,Viralimalai,BALASUBRAMANIAN M,IND,156,0,156,193423,224564,-23598
179,Viralimalai,RAJAVARMAN R,IND,119,0,119,193423,224564,-23598
179,Viralimalai,RAMESHKUMAR.P,IND,93,0,93,193423,224564,-23598
179,Viralimalai,MANIKANDAN K,IND,73,0,73,193423,224564,-23598
179,Viralimalai,SYEED MOHAMED J,IND,50,0,50,193423,224564,-23598
179,Viralimalai,ELAYARAJA R,IND,37,0,37,193423,224564,-23598
179,Viralimalai,SENTHILKUMAR P,My India Party,35,0,35,193423,224564,-23598
179,Viralimalai,ABDUL NAZAR K,IND,33,0,33,193423,224564,-23598
179,Viralimalai,VIJAY A,Anna Dravidar Kazhagam,26,0,26,193423,224564,-23598
180,Pudukkottai,V . MUTHURAJA,DMK,83792,2010,85802,179892,243233,13001
180,Pudukkottai,KARTHIK THONDAIMAN,AIADMK,72247,554,72801,179892,243233,13001
180,Pudukkottai,SASIKUMAR,NTK,11411,92,11503,179892,243233,13001
180,Pudukkottai,S . MOORTHY,MNM,3920,28,3948,179892,243233,13001
180,Pudukkottai,M . SUBRAMANIAN,DMDK,1857,16,1873,179892,243233,13001
180,Pudukkottai,NOTA,NOTA,596,8,604,179892,243233,13001
180,Pudukkottai,DURAI GUNA,IND,475,1,476,179892,243233,13001
180,Pudukkottai,VENGADESHWARAN,BSP,456,7,463,179892,243233,13001
180,Pudukkottai,M. SARAVANA DEVA,Namadhu Makkal Katchi,416,8,424,179892,243233,13001
180,Pudukkottai,KARTHIKEYAN,IND,388,5,393,179892,243233,13001
180,Pudukkottai,V. N. MUTHUKUMAR,IND,380,0,380,179892,243233,13001
180,Pudukkottai,A. RAJASEKAR,IND,250,0,250,179892,243233,13001
180,Pudukkottai,S . SOUNDAR RAJA,IND,204,1,205,179892,243233,13001
180,Pudukkottai,K . DHANAGOPAL,IND,180,0,180,179892,243233,13001
180,Pudukkottai,KARUPPAIAH . C,IND,103,1,104,179892,243233,13001
180,Pudukkottai,KUMAR,My India Party,95,0,95,179892,243233,13001
180,Pudukkottai,M . RAJINIKANTH,IND,90,0,90,179892,243233,13001
180,Pudukkottai,S . SAHUL AMEEDU,IND,88,1,89,179892,243233,13001
180,Pudukkottai,P. VIJAYAKUMAR,IND,71,0,71,179892,243233,13001
180,Pudukkottai,S . KARTHIKEYAN,IND,58,0,58,179892,243233,13001
180,Pudukkottai,N. VEERIAH,IND,42,0,42,179892,243233,13001
180,Pudukkottai,I . ABDULLAH,IND,41,0,41,179892,243233,13001
181,Thirumayam,S.REGUPATHY,DMK,70594,755,71349,174031,227182,1382
181,Thirumayam,P.K.VAIRAMUTHU,AIADMK,69595,372,69967,174031,227182,1382
181,Thirumayam,K.SELVAKUMAR,IND,15111,33,15144,174031,227182,1382
181,Thirumayam,U.SIVARAMAN,NTK,11019,42,11061,174031,227182,1382
181,Thirumayam,S.MUNIARAJU,AMMK,1485,18,1503,174031,227182,1382
181,Thirumayam,R.THIRUMENI,MNM,1350,6,1356,174031,227182,1382
181,Thirumayam,NOTA,NOTA,568,1,569,174031,227182,1382
181,Thirumayam,S. GANDIPAN,My India Party,554,0,554,174031,227182,1382
181,Thirumayam,M.SELVAKUMAR,IND,456,0,456,174031,227182,1382
181,Thirumayam,C. ALAGU SUBBIAH,IND,408,4,412,174031,227182,1382
181,Thirumayam,M. DURAIRAJAN,IND,365,0,365,174031,227182,1382
181,Thirumayam,M.SELVAKUMAR,IND,315,0,315,174031,227182,1382
181,Thirumayam,R.SIVAKUMAR,PT,236,2,238,174031,227182,1382
181,Thirumayam,S.SELVAKUMAR,IND,109,0,109,174031,227182,1382
181,Thirumayam,R. PALANIYAPPAN,IND,92,0,92,174031,227182,1382
181,Thirumayam,M.SELVAKUMAR,IND,87,0,87,174031,227182,1382
181,Thirumayam,S.PURACHIBALAN,Anna Dravidar Kazhagam,74,0,74,174031,227182,1382
181,Thirumayam,MUTHUADAIKKAN @ ADAIKKALAM,IND,73,1,74,174031,227182,1382
181,Thirumayam,R.SUNDARAM,IND,69,1,70,174031,227182,1382
181,Thirumayam,S.MANIKANDAN,IND,66,0,66,174031,227182,1382
181,Thirumayam,M.KARTHICK,IND,65,0,65,174031,227182,1382
181,Thirumayam,K.SELVAKUMAR,IND,54,0,54,174031,227182,1382
181,Thirumayam,AL.MATHIALAGAN,IND,51,0,51,174031,227182,1382
182,Alangudi,SIVA.V.MEYYANATHAN,DMK,86743,1192,87935,171842,216933,25847
182,Alangudi,DHARMA THANGAVEL,AIADMK,61918,170,62088,171842,216933,25847
182,Alangudi,C.THIRUCHELVAM,NTK,15403,74,15477,171842,216933,25847
182,Alangudi,D.VIDANGAR,AMMK,2899,25,2924,171842,216933,25847
182,Alangudi,N.VAIRAVAN,MNM,1221,9,1230,171842,216933,25847
182,Alangudi,NOTA,NOTA,699,3,702,171842,216933,25847
182,Alangudi,M.CHINNADURAI,BSP,442,2,444,171842,216933,25847
182,Alangudi,V.KANNADASAN,IND,343,0,343,171842,216933,25847
182,Alangudi,T.VINAYAGAMOORTHY,IND,199,0,199,171842,216933,25847
182,Alangudi,P.BALAMURUGAN,My India Party,179,1,180,171842,216933,25847
182,Alangudi,G.MANIMEGALAI,CPI(ML)(L),163,2,165,171842,216933,25847
182,Alangudi,C.JAYA,Anaithu Makkal Puratchi Katchi,154,1,155,171842,216933,25847
183,Aranthangi,RAMACHANDRAN T,INC,80902,933,81835,168048,236048,30893
183,Aranthangi,RAJANAYAGAM M,AIADMK,50655,287,50942,168048,236048,30893
183,Aranthangi,HUMAYUN KABIR M I,NTK,18398,62,18460,168048,236048,30893
183,Aranthangi,SIVASHANMUGAM K,AMMK,4678,21,4699,168048,236048,30893
183,Aranthangi,VELRAJ. K P,IND,3150,14,3164,168048,236048,30893
183,Aranthangi,MUTHUSELVAM V,IND,2159,5,2164,168048,236048,30893
183,Aranthangi,"DHETCHENA MOORTHY, Dr. S",IND,1064,16,1080,168048,236048,30893
183,Aranthangi,SHAIK MOHAMED B,MNM,960,6,966,168048,236048,30893
183,Aranthangi,JEEVA A,BSP,633,3,636,168048,236048,30893
183,Aranthangi,AMALADOSS SANDHIYAGU,PT,599,13,612,168048,236048,30893
183,Aranthangi,NOTA,NOTA,524,0,524,168048,236048,30893
183,Aranthangi,PANDIYAN V,IND,505,0,505,168048,236048,30893
183,Aranthangi,MAHENDRAN K,IND,493,0,493,168048,236048,30893
183,Aranthangi,SELVAKUMAR K,IND,391,0,391,168048,236048,30893
183,Aranthangi,MUTHUKKARUPPAIAH K,IND,334,0,334,168048,236048,30893
183,Aranthangi,RAMASAMY R S,IND,212,0,212,168048,236048,30893
183,Aranthangi,SYED SULTHAN IBRAHIM A,IND,201,1,202,168048,236048,30893
183,Aranthangi,TILLAINATHAN R,IND,179,1,180,168048,236048,30893
183,Aranthangi,RAMALINGASWAMI ADIHITHAN. PPC,Akhila India Jananayaka Makkal Katchi (Dr. Isaac),167,1,168,168048,236048,30893
183,Aranthangi,SAKTHIVEL K,Tamizhaga Murpokku Makkal Katchi,162,0,162,168048,236048,30893
183,Aranthangi,ARJUNAN R,IND,140,0,140,168048,236048,30893
183,Aranthangi,KUMARAPPAN B,My India Party,125,0,125,168048,236048,30893
183,Aranthangi,JEGADEESAN R,IND,54,0,54,168048,236048,30893
184,Karaikudi,S.Mangudi,INC,73777,2177,75954,212456,315378,21589
184,Karaikudi,H.Raja,BJP,53863,502,54365,212456,315378,21589
184,Karaikudi,Dherpoki V Pandi,AMMK,44561,303,44864,212456,315378,21589
184,Karaikudi,N.Durai Manickam,NTK,23725,147,23872,212456,315378,21589
184,Karaikudi,S.Rajkumar,MNM,8260,91,8351,212456,315378,21589
184,Karaikudi,NOTA,NOTA,1329,20,1349,212456,315378,21589
184,Karaikudi,B.Vanitha,PT,698,4,702,212456,315378,21589
184,Karaikudi,N.Baluswamy,BSP,649,3,652,212456,315378,21589
184,Karaikudi,N.Meenal,IND,543,5,548,212456,315378,21589
184,Karaikudi,K.Velu,IND,498,6,504,212456,315378,21589
184,Karaikudi,M.Naina Mohamed,IND,412,4,416,212456,315378,21589
184,Karaikudi,A.Ganesan,IND,340,6,346,212456,315378,21589
184,Karaikudi,Rajkumar.G,Anna MGR Dravida Makkal Kalgam,338,3,341,212456,315378,21589
184,Karaikudi,A.Paramasivam,IND,192,0,192,212456,315378,21589
185,Tiruppattur,KR.PERIYAKARUPPAN,DMK,102261,1421,103682,210766,290664,37374
185,Tiruppattur,MARUDHU ALAGURAJ,AIADMK,65915,393,66308,210766,290664,37374
185,Tiruppattur,KOTTAIKUMAR,NTK,14518,53,14571,210766,290664,37374
185,Tiruppattur,C.PARAMASIVAM,IND,13186,16,13202,210766,290664,37374
185,Tiruppattur,K.K.UMADHEVAN,AMMK,7396,52,7448,210766,290664,37374
185,Tiruppattur,A.AMALAN SAVARIMUTHU,Indiya Jananayaka Katchi,856,6,862,210766,290664,37374
185,Tiruppattur,NOTA,NOTA,845,8,853,210766,290664,37374
185,Tiruppattur,PERIYASAMY,IND,604,1,605,210766,290664,37374
185,Tiruppattur,A.PARTHASARATHY,IND,465,0,465,210766,290664,37374
185,Tiruppattur,A.MALLIKA,IND,444,0,444,210766,290664,37374
185,Tiruppattur,K.S.K.RAJESH,IND,352,0,352,210766,290664,37374
185,Tiruppattur,PALANIAPPAN,IND,333,0,333,210766,290664,37374
185,Tiruppattur,M.SARASWATHI,PT,240,1,241,210766,290664,37374
185,Tiruppattur,P.SELVARAJ,IND,221,0,221,210766,290664,37374
185,Tiruppattur,P.RAJESWARI,IND,152,0,152,210766,290664,37374
185,Tiruppattur,K.VEERAPANDIAN,My India Party,143,1,144,210766,290664,37374
185,Tiruppattur,M.MOHAMED RABEEK,IND,122,0,122,210766,290664,37374
185,Tiruppattur,P.JEYACHANDRAN,IND,115,0,115,210766,290664,37374
185,Tiruppattur,S.MURUGAN,Anaithu Makkal Puratchi Katchi,95,1,96,210766,290664,37374
185,Tiruppattur,G.ABDUL KISHORE BABU,IND,84,1,85,210766,290664,37374
185,Tiruppattur,A.KARTHIKA,IND,80,0,80,210766,290664,37374
185,Tiruppattur,RM.MURUGESAN,IND,69,0,69,210766,290664,37374
185,Tiruppattur,C.KANNAN,IND,67,1,68,210766,290664,37374
185,Tiruppattur,MUTHULAKSHMI,IND,65,0,65,210766,290664,37374
185,Tiruppattur,J.VEERAYI,IND,65,0,65,210766,290664,37374
185,Tiruppattur,ANANDHAN K,IND,62,0,62,210766,290664,37374
185,Tiruppattur,RENUKA,IND,56,0,56,210766,290664,37374
186,Sivaganga,PR. Senthilnathan,AIADMK,81267,886,82153,202044,299126,-11253
186,Sivaganga,S. Gunasekaran,CPI,69101,1799,70900,202044,299126,-11253
186,Sivaganga,R. Mallika,NTK,22301,199,22500,202044,299126,-11253
186,Sivaganga,K. Anbarasan,AMMK,19631,193,19824,202044,299126,-11253
186,Sivaganga,Joseph. C,MNM,2076,29,2105,202044,299126,-11253
186,Sivaganga,P. Viswanathan,IND,1318,14,1332,202044,299126,-11253
186,Sivaganga,NOTA,NOTA,1258,12,1270,202044,299126,-11253
186,Sivaganga,N. Pandimuthu,My India Party,369,4,373,202044,299126,-11253
186,Sivaganga,Dr. A. Parthasarathy,IND,342,3,345,202044,299126,-11253
186,Sivaganga,Vimalraj,IND,307,2,309,202044,299126,-11253
186,Sivaganga,Vadivel. C,Anaithu Makkal Puratchi Katchi,239,2,241,202044,299126,-11253
186,Sivaganga,M. Ravi,IND,175,0,175,202044,299126,-11253
186,Sivaganga,R. Gunasekaran,IND,145,10,155,202044,299126,-11253
186,Sivaganga,M. Thirukumaran,IND,124,3,127,202044,299126,-11253
186,Sivaganga,K. Kalaiselvam,IND,120,3,123,202044,299126,-11253
186,Sivaganga,C. Kaningprabhu,IND,109,3,112,202044,299126,-11253
187,Manamadurai,Tamilarasi A.,DMK,87827,1537,89364,203061,276762,14091
187,Manamadurai,Nagarajan S.,AIADMK,74433,840,75273,203061,276762,14091
187,Manamadurai,Shanmugapriya M.,NTK,22916,312,23228,203061,276762,14091
187,Manamadurai,Mariappankennady S.,AMMK,10074,157,10231,203061,276762,14091
187,Manamadurai,Sivasankari P.,MNM,2219,38,2257,203061,276762,14091
187,Manamadurai,NOTA,NOTA,1318,15,1333,203061,276762,14091
187,Manamadurai,Rajaiah  C.,IND,369,2,371,203061,276762,14091
187,Manamadurai,Chandrasekar M.,Anaithu Makkal Puratchi Katchi,226,3,229,203061,276762,14091
187,Manamadurai,Muthumari K.,IND,185,0,185,203061,276762,14091
187,Manamadurai,Thamaraiselvi S.,IND,140,2,142,203061,276762,14091
187,Manamadurai,Muralitharan M.,Anna MGR Dravida Makkal Kalgam,128,0,128,203061,276762,14091
187,Manamadurai,Duraipandi M.,IND,125,0,125,203061,276762,14091
187,Manamadurai,Rajendran A.,My India Party,104,7,111,203061,276762,14091
187,Manamadurai,Karuppaiah S.,IND,83,1,84,203061,276762,14091
188,Melur,PERIYAPULLAN @ SELVAM  P.,AIADMK,83126,218,83344,182782,244055,-35162
188,Melur,RAVICHANDRAN  T.,INC,47727,455,48182,182782,244055,-35162
188,Melur,SELVARAJ  A.,AMMK,34027,235,34262,182782,244055,-35162
188,Melur,KARUPPUSAMY  P.,NTK,10606,63,10669,182782,244055,-35162
188,Melur,KATHIRESAN  K.,MNM,2161,15,2176,182782,244055,-35162
188,Melur,NOTA,NOTA,875,9,884,182782,244055,-35162
188,Melur,PANDI  K.,IND,736,0,736,182782,244055,-35162
188,Melur,BALAN  T.,IND,630,0,630,182782,244055,-35162
188,Melur,GOBALAKRISHNAN  M.,IND,350,0,350,182782,244055,-35162
188,Melur,MOHANRAM  C.,IND,342,0,342,182782,244055,-35162
188,Melur,DHINAKARAN  S.,IND,274,0,274,182782,244055,-35162
188,Melur,SENTHILRAJ  K.,My India Party,270,0,270,182782,244055,-35162
188,Melur,KANNAN  P.,IND,257,1,258,182782,244055,-35162
188,Melur,NAGENDRAN  N.,IND,199,1,200,182782,244055,-35162
188,Melur,SIVASAMY  R.,IND,109,1,110,182782,244055,-35162
188,Melur,DHARMAR  P.,IND,95,0,95,182782,244055,-35162
189,Madurai East,MOORTHY P,DMK,120459,2270,122729,237892,327288,49604
189,Madurai East,GOPALAKRISHNAN R,AIADMK,72588,537,73125,237892,327288,49604
189,Madurai East,LATHA J,NTK,17504,164,17668,237892,327288,49604
189,Madurai East,MUTHUKRISHNAN I,MNM,11864,129,11993,237892,327288,49604
189,Madurai East,SARAVANAN T,AMMK,6636,93,6729,237892,327288,49604
189,Madurai East,NOTA,NOTA,1923,21,1944,237892,327288,49604
189,Madurai East,BALAMURUGAN A,PT,1737,18,1755,237892,327288,49604
189,Madurai East,PALANIAMMAL P,IND,345,4,349,237892,327288,49604
189,Madurai East,CHANDRASEKARAN V,IND,345,1,346,237892,327288,49604
189,Madurai East,MUSTAK MOHAMED.A.K,Tipu Sultan Party,306,2,308,237892,327288,49604
189,Madurai East,GANDHI K,IND,232,1,233,237892,327288,49604
189,Madurai East,JEYAKUMAR P,IND,231,1,232,237892,327288,49604
189,Madurai East,MUTHU KRISHNAN M,Anaithu Makkal Puratchi Katchi,151,1,152,237892,327288,49604
189,Madurai East,RAJA P,My India Party,120,2,122,237892,327288,49604
189,Madurai East,PRABAHARAN M,Bahujan Dravida Party,109,3,112,237892,327288,49604
189,Madurai East,DINESH G,IND,95,0,95,237892,327288,49604
190,Sholavandan,VENKATESAN A,DMK,83247,993,84240,175361,217472,17045
190,Sholavandan,MANICKAM K,AIADMK,66792,403,67195,175361,217472,17045
190,Sholavandan,SENGANNAN G,NTK,13783,153,13936,175361,217472,17045
190,Sholavandan,JEYALAKSHMI M,DMDK,3534,48,3582,175361,217472,17045
190,Sholavandan,YOGANATHAN S,MNM,3000,31,3031,175361,217472,17045
190,Sholavandan,NOTA,NOTA,946,15,961,175361,217472,17045
190,Sholavandan,MOORTHI M,IND,363,0,363,175361,217472,17045
190,Sholavandan,RAJKUMAR V,IND,347,6,353,175361,217472,17045
190,Sholavandan,KANDAVEL S,IND,292,2,294,175361,217472,17045
190,Sholavandan,INDURANI S,PT,248,2,250,175361,217472,17045
190,Sholavandan,MOORTHY P,IND,200,0,200,175361,217472,17045
190,Sholavandan,SILAMBARASAN P,Bahujan Dravida Party,143,3,146,175361,217472,17045
190,Sholavandan,MALAICHAMY A,IND,133,0,133,175361,217472,17045
190,Sholavandan,ESWARI T,CPI(ML)(L),121,4,125,175361,217472,17045
190,Sholavandan,KATHIRESAN P,IND,102,2,104,175361,217472,17045
190,Sholavandan,VARATHARAJAN C,IND,89,0,89,175361,217472,17045
190,Sholavandan,DHANAGOPAL S,IND,86,2,88,175361,217472,17045
190,Sholavandan,KRISHNASAMY P,IND,81,3,84,175361,217472,17045
190,Sholavandan,RAJKUMAR K,My India Party,71,0,71,175361,217472,17045
190,Sholavandan,SEKAR N,IND,70,0,70,175361,217472,17045
190,Sholavandan,VETRIVEL J,IND,46,0,46,175361,217472,17045
191,Madurai North,THALAPATHI G,DMK,71949,1061,73010,156556,242185,22916
191,Madurai North,SARAVANAN P,BJP,49700,394,50094,156556,242185,22916
191,Madurai North,ANBARASI S,NTK,15178,133,15311,156556,242185,22916
191,Madurai North,ALAGAR M,MNM,12019,83,12102,156556,242185,22916
191,Madurai North,JEYAPAL M,AMMK,3235,45,3280,156556,242185,22916
191,Madurai North,NOTA,NOTA,1548,16,1564,156556,242185,22916
191,Madurai North,NATARAJAN R,IND,167,1,168,156556,242185,22916
191,Madurai North,VASANTHAKUMAR S,Anna Dravidar Kazhagam,167,0,167,156556,242185,22916
191,Madurai North,SANKARAPANDI P,IND,161,2,163,156556,242185,22916
191,Madurai North,ABUBAKKAR SITHICK J,IND,138,1,139,156556,242185,22916
191,Madurai North,THEIVAMMAL K,IND,124,1,125,156556,242185,22916
191,Madurai North,VOLTAIRE M J,SOCIALIST UNITY CENTRE OF INDIA (COMMUNIST),114,1,115,156556,242185,22916
191,Madurai North,ISMAIL D,IND,105,0,105,156556,242185,22916
191,Madurai North,RAAM VISHWAKARMA T,IND,93,1,94,156556,242185,22916
191,Madurai North,KESAVARAJAH J,IND,69,1,70,156556,242185,22916
191,Madurai North,KUPPUSAMY N,IND,49,0,49,156556,242185,22916
192,Madurai South,BOOMINATHAN.M,DMK,62284,528,62812,147833,229366,6515
192,Madurai South,SARAVANAN. S.S,AIADMK,56005,292,56297,147833,229366,6515
192,Madurai South,ESWARAN.G,MNM,12773,48,12821,147833,229366,6515
192,Madurai South,ABBAS.M,NTK,10430,53,10483,147833,229366,6515
192,Madurai South,RAAJALINGAM.SHA,AMMK,2662,10,2672,147833,229366,6515
192,Madurai South,NOTA,NOTA,1532,19,1551,147833,229366,6515
192,Madurai South,SARAVANAN.R,IND,254,3,257,147833,229366,6515
192,Madurai South,JEYA.K,IND,175,3,178,147833,229366,6515
192,Madurai South,RAJKUMAR(a)MANIKANDAN.K,IND,162,0,162,147833,229366,6515
192,Madurai South,VENGADACHALAPATHY.T.S,IND,158,1,159,147833,229366,6515
192,Madurai South,BHARATHI KANNAMMA. S,New Generation People’s Party,140,0,140,147833,229366,6515
192,Madurai South,RAVICHANDRAN.V.C,IND,116,0,116,147833,229366,6515
192,Madurai South,SADAM HUSSAIN.K,My India Party,104,0,104,147833,229366,6515
192,Madurai South,UMESH.K.R,IND,81,0,81,147833,229366,6515
193,Madurai Central,PALANIVEL THIAGA RAJAN,DMK,72231,974,73205,149430,240914,34176
193,Madurai Central,JOTHI MUTHURAMALINGAM N,AIADMK,38834,195,39029,149430,240914,34176
193,Madurai Central,MANI B,MNM,14437,58,14495,149430,240914,34176
193,Madurai Central,PANDIAMMAL J,NTK,11156,59,11215,149430,240914,34176
193,Madurai Central,KREMMER SURESH,IND,4880,27,4907,149430,240914,34176
193,Madurai Central,SIKKANDAR BATCHA G S,SOCIAL DEMOCRATIC PARTY OF INDIA,3327,20,3347,149430,240914,34176
193,Madurai Central,NOTA,NOTA,1432,9,1441,149430,240914,34176
193,Madurai Central,KRISHNAPRABBU M R,IND,437,3,440,149430,240914,34176
193,Madurai Central,ESWARI M,My India Party,285,2,287,149430,240914,34176
193,Madurai Central,THAVAMANI A,BSP,283,3,286,149430,240914,34176
193,Madurai Central,ELANGOVAN R,IND,264,0,264,149430,240914,34176
193,Madurai Central,RAJASURIYAA K R,IND,192,1,193,149430,240914,34176
193,Madurai Central,RAJAKUMAR NAIDU E V S,Tamil Telugu National Party,175,1,176,149430,240914,34176
193,Madurai Central,SIVASANKAR S,IND,94,0,94,149430,240914,34176
193,Madurai Central,SATHIYENDRAN N,IND,51,0,51,149430,240914,34176
194,Madurai West,RAJU. K,AIADMK,83586,297,83883,201694,305199,-9121
194,Madurai West,CHINNAMMAL. C,DMK,73463,1299,74762,201694,305199,-9121
194,Madurai West,VETRIKUMARAN. C,NTK,18133,91,18224,201694,305199,-9121
194,Madurai West,MUNIYASAMY. V,MNM,15749,100,15849,201694,305199,-9121
194,Madurai West,BALACHANDRAN. P,DMDK,3384,33,3417,201694,305199,-9121
194,Madurai West,NAGAJOTHI. K,Tamil Nadu Ilangyar Katchi,2483,26,2509,201694,305199,-9121
194,Madurai West,NOTA,NOTA,1757,17,1774,201694,305199,-9121
194,Madurai West,RAMU. N,IND,368,0,368,201694,305199,-9121
194,Madurai West,KARTHIKEYAN. R,Akhil Bharat Hindu Mahasabha,315,3,318,201694,305199,-9121
194,Madurai West,VENKATESAN. M,IND,126,0,126,201694,305199,-9121
194,Madurai West,PREMKUMAR. M,IND,122,0,122,201694,305199,-9121
194,Madurai West,ARASU THIRUVALAVAN. K. K,IND,96,1,97,201694,305199,-9121
194,Madurai West,SULTHAN BADUSHA. J,Anna MGR Dravida Makkal Kalgam,79,0,79,201694,305199,-9121
194,Madurai West,ANBUMANIKANDANTAMILSOORIYAN.K,IND,73,0,73,201694,305199,-9121
194,Madurai West,SEBASTHIYAN. B,IND,49,0,49,201694,305199,-9121
194,Madurai West,SULTHAN BASHA. K,IND,43,1,44,201694,305199,-9121
195,Thiruparankundram,"RAJANCHELLAPPA, V.V.",AIADMK,103059,624,103683,235849,318907,-29489
195,Thiruparankundram,PONNUTHAI,CPM,73032,1162,74194,235849,318907,-29489
195,Thiruparankundram,"REVATHY, R.",NTK,22582,140,22722,235849,318907,-29489
195,Thiruparankundram,"BHARANIRAJAN, M.",MNM,16662,88,16750,235849,318907,-29489
195,Thiruparankundram,"DAVID ANNADURAI, K.",AMMK,10120,70,10190,235849,318907,-29489
195,Thiruparankundram,NOTA,NOTA,2039,34,2073,235849,318907,-29489
195,Thiruparankundram,"ARUMUGAM, V.",IND,2002,3,2005,235849,318907,-29489
195,Thiruparankundram,"SAVITHA, R.",Anna MGR Dravida Makkal Kalgam,591,1,592,235849,318907,-29489
195,Thiruparankundram,"MURUGAN, K.R.",IND,555,7,562,235849,318907,-29489
195,Thiruparankundram,"RAJAMANI, V.",Namadhu Makkal Katchi,537,1,538,235849,318907,-29489
195,Thiruparankundram,"PACKIYASELVI, K.",IND,401,1,402,235849,318907,-29489
195,Thiruparankundram,"UKKRA PANDIYAN, S.",IND,301,1,302,235849,318907,-29489
195,Thiruparankundram,"PILLAI, M.M.",IND,283,1,284,235849,318907,-29489
195,Thiruparankundram,"BALAMURUGAN, R.",IND,256,1,257,235849,318907,-29489
195,Thiruparankundram,"KARUNAKARAN, M.",IND,246,0,246,235849,318907,-29489
195,Thiruparankundram,"SEKAR, S.",IND,200,0,200,235849,318907,-29489
195,Thiruparankundram,"PALANIKUMAR, M.",Ambedkar Political Party,173,4,177,235849,318907,-29489
195,Thiruparankundram,"MURUGESAN, A.",My India Party,131,0,131,235849,318907,-29489
195,Thiruparankundram,"ILANGOVAN, P.",IND,114,0,114,235849,318907,-29489
195,Thiruparankundram,"RADHA (A) GUNASEKARAN, M.",IND,114,0,114,235849,318907,-29489
195,Thiruparankundram,"MOHIDEEN ABDUL KADAR, M.K.",IND,98,0,98,235849,318907,-29489
195,Thiruparankundram,"MANIKANDAN, S.",IND,81,1,82,235849,318907,-29489
195,Thiruparankundram,"SANKAR THAYAL SHARMA, M.",IND,80,0,80,235849,318907,-29489
195,Thiruparankundram,"RAMACHANDRAN, K.",IND,52,1,53,235849,318907,-29489
196,Thirumangalam,UDHAYAKUMAR R B,AIADMK,99294,1044,100338,220495,276778,-14087
196,Thirumangalam,MANIMARAN M,DMK,84381,1870,86251,220495,276778,-14087
196,Thirumangalam,ATHI NARAYANAN K,AMMK,13554,226,13780,220495,276778,-14087
196,Thirumangalam,SARAL M,NTK,11375,218,11593,220495,276778,-14087
196,Thirumangalam,RAMKUMAR M,MNM,2748,27,2775,220495,276778,-14087
196,Thirumangalam,VEERANAN S,IND,1566,10,1576,220495,276778,-14087
196,Thirumangalam,NOTA,NOTA,958,13,971,220495,276778,-14087
196,Thirumangalam,RAMANATHAN A,IND,683,1,684,220495,276778,-14087
196,Thirumangalam,MUTHUVELRAJ P,IND,501,2,503,220495,276778,-14087
196,Thirumangalam,RAMANATHAN M,IND,433,0,433,220495,276778,-14087
196,Thirumangalam,RAJANBABU P,IND,276,2,278,220495,276778,-14087
196,Thirumangalam,MUTHURAJA M,IND,187,3,190,220495,276778,-14087
196,Thirumangalam,RAMAMOORTHI R,IND,163,2,165,220495,276778,-14087
196,Thirumangalam,BALAMURUGAN N R,IND,129,2,131,220495,276778,-14087
196,Thirumangalam,ARUMUGAM K,Lok Jan Shakti Party,119,3,122,220495,276778,-14087
196,Thirumangalam,NIRMAL M,My India Party,119,3,122,220495,276778,-14087
196,Thirumangalam,MARIKANNAN A,National Democratic Party of South India,95,3,98,220495,276778,-14087
196,Thirumangalam,THIRALIPANDI N,IND,78,4,82,220495,276778,-14087
196,Thirumangalam,JEGADEESH KUMAR R,IND,74,1,75,220495,276778,-14087
196,Thirumangalam,ALAGARSAMY M,IND,71,0,71,220495,276778,-14087
196,Thirumangalam,VAIRASEEMAN G,IND,64,0,64,220495,276778,-14087
196,Thirumangalam,DURAIPANDI B,IND,61,1,62,220495,276778,-14087
196,Thirumangalam,KALI A,IND,44,1,45,220495,276778,-14087
196,Thirumangalam,CHANDRASEKARAN R,IND,42,2,44,220495,276778,-14087
196,Thirumangalam,VEERAMANI V,IND,41,1,42,220495,276778,-14087
197,Usilampatti,AYYAPPAN P,AIADMK,70780,475,71255,212513,283590,-7477
197,Usilampatti,KATHIRAVAN P V,DMK,62877,901,63778,212513,283590,-7477
197,Usilampatti,MAHENDRAN I,AMMK,54758,733,55491,212513,283590,-7477
197,Usilampatti,IYNDHUKOVILAN G,NTK,15089,268,15357,212513,283590,-7477
197,Usilampatti,ARUMUGAM K,IND,1238,9,1247,212513,283590,-7477
197,Usilampatti,THIRUSELVAM C,PT,1149,12,1161,212513,283590,-7477
197,Usilampatti,NOTA,NOTA,1015,17,1032,212513,283590,-7477
197,Usilampatti,ARASUMAYAN M,All India Jananayaka Makkal Kazhagam,961,6,967,212513,283590,-7477
197,Usilampatti,KATHIRAVAN A,IND,523,5,528,212513,283590,-7477
197,Usilampatti,Dhanasekaran T,IND,477,1,478,212513,283590,-7477
197,Usilampatti,BHARATH V,My India Party,372,6,378,212513,283590,-7477
197,Usilampatti,ARUNKUMAR M,IND,359,3,362,212513,283590,-7477
197,Usilampatti,MAHENDRAN A,IND,247,0,247,212513,283590,-7477
197,Usilampatti,ALAGUMURUGESAN K,IND,155,3,158,212513,283590,-7477
197,Usilampatti,ANANTHA KUMAR N,IND,69,5,74,212513,283590,-7477
198,Andipatti,A.MAHARAJAN,DMK,92057,1484,93541,209540,275943,8538
198,Andipatti,A.LOGIRAJAN,AIADMK,84542,461,85003,209540,275943,8538
198,Andipatti,R.JEYAKUMAR,AMMK,11746,150,11896,209540,275943,8538
198,Andipatti,JEYAKUMAR,NTK,11034,182,11216,209540,275943,8538
198,Andipatti,S.GUNASEKARAN,MNM,2958,52,3010,209540,275943,8538
198,Andipatti,NOTA,NOTA,1308,25,1333,209540,275943,8538
198,Andipatti,C.KANIVEL,Anaithu Makkal Puratchi Katchi,650,0,650,209540,275943,8538
198,Andipatti,VELMANI,IND,566,6,572,209540,275943,8538
198,Andipatti,M.RAGHUNATHAN,IND,457,0,457,209540,275943,8538
198,Andipatti,S.KAMATCHI,BSP,387,5,392,209540,275943,8538
198,Andipatti,P.PANDIDURAI,IND,226,1,227,209540,275943,8538
198,Andipatti,P.PANIVURAJA,IND,155,1,156,209540,275943,8538
198,Andipatti,MARIYAMMAL,IND,148,1,149,209540,275943,8538
198,Andipatti,V.JEYAKODI,IND,141,4,145,209540,275943,8538
198,Andipatti,BALAMURUGAN,National Democratic Party of South India,122,5,127,209540,275943,8538
198,Andipatti,M.EASWARAN,IND,125,2,127,209540,275943,8538
198,Andipatti,S.GOVINDHARAJ,All India MGR Makkal Munnetra Kazhagam,112,3,115,209540,275943,8538
198,Andipatti,A.VELUCHAMY,Anna Puratchi Thalaivar Amma Dravida Munnetra Kazhagam,114,1,115,209540,275943,8538
198,Andipatti,M.DIVAKAR,IND,115,0,115,209540,275943,8538
198,Andipatti,M.KUMARAN,My India Party,105,4,109,209540,275943,8538
198,Andipatti,K.KASENDRAN @ GAJENDRAN,IND,84,1,85,209540,275943,8538
199,Periyakulam,K.S.SARAVANAKUMAAR,DMK,90360,1891,92251,201797,285036,21321
199,Periyakulam,M Murugan,AIADMK,70444,486,70930,201797,285036,21321
199,Periyakulam,Dr.K.Kathirkamu,AMMK,16317,107,16424,201797,285036,21321
199,Periyakulam,Vimala,NTK,11660,134,11794,201797,285036,21321
199,Periyakulam,S.PANDIYARAJAN,MNM,5626,54,5680,201797,285036,21321
199,Periyakulam,NOTA,NOTA,2414,37,2451,201797,285036,21321
199,Periyakulam,MADHU BHARATHI,IND,622,6,628,201797,285036,21321
199,Periyakulam,MURUGAN,IND,335,4,339,201797,285036,21321
199,Periyakulam,S.Chinnamuthu,My India Party,299,2,301,201797,285036,21321
199,Periyakulam,M.RAJENDRAN,IND,237,5,242,201797,285036,21321
199,Periyakulam,A.Murugesan,SOCIALIST UNITY CENTRE OF INDIA (COMMUNIST),201,1,202,201797,285036,21321
199,Periyakulam,"A.C.MOHAN RAJ B.P.T.,",IND,148,1,149,201797,285036,21321
199,Periyakulam,M.Muneeswaran,IND,143,0,143,201797,285036,21321
199,Periyakulam,P.RAMAIYA,IND,112,0,112,201797,285036,21321
199,Periyakulam,M.Muniyappan,IND,94,0,94,201797,285036,21321
199,Periyakulam,C.MAYAZHAKU,IND,56,1,57,201797,285036,21321
200,Bodinayakanur,O.PANNEERSELVAM,AIADMK,99296,754,100050,214795,278012,-11021
200,Bodinayakanur,THANGATAMILSELVAN,DMK,87142,1887,89029,214795,278012,-11021
200,Bodinayakanur,M.PREM CHANDAR,NTK,10982,132,11114,214795,278012,-11021
200,Bodinayakanur,M.MUTHUSAMY,AMMK,5594,55,5649,214795,278012,-11021
200,Bodinayakanur,P.GANESH KUMAR,MNM,4069,59,4128,214795,278012,-11021
200,Bodinayakanur,NOTA,NOTA,1381,22,1403,214795,278012,-11021
200,Bodinayakanur,K.I.M HAKKEEM,All India Trinamool Congress,552,7,559,214795,278012,-11021
200,Bodinayakanur,TAMILSELVAN,IND,441,2,443,214795,278012,-11021
200,Bodinayakanur,G.SENTHIL KUMAR,IND,402,0,402,214795,278012,-11021
200,Bodinayakanur,N.SALEEM,IND,353,1,354,214795,278012,-11021
200,Bodinayakanur,M.ANANTHARAJ,IND,269,1,270,214795,278012,-11021
200,Bodinayakanur,P.KUMARAGURUBARAN,IND,218,1,219,214795,278012,-11021
200,Bodinayakanur,ARUN KUMAR,My India Party,139,4,143,214795,278012,-11021
200,Bodinayakanur,P.NAGENDHREN,IND,133,2,135,214795,278012,-11021
200,Bodinayakanur,N.KRISHNAN,IND,125,1,126,214795,278012,-11021
200,Bodinayakanur,P.MANIMARAN,IND,108,9,117,214795,278012,-11021
200,Bodinayakanur,S.KRISHNAVENI,Anna Puratchi Thalaivar Amma Dravida Munnetra Kazhagam,98,2,100,214795,278012,-11021
200,Bodinayakanur,C.ANBAZHAKAN,IND,91,3,94,214795,278012,-11021
200,Bodinayakanur,THENI.T.KARNAN,Anna Dravidar Kazhagam,80,0,80,214795,278012,-11021
200,Bodinayakanur,P.KARUPPIAH,Bahujan Dravida Party,77,0,77,214795,278012,-11021
200,Bodinayakanur,V.RAMPRAKAASH,IND,69,2,71,214795,278012,-11021
200,Bodinayakanur,V.NANDHAGOPAL,IND,68,0,68,214795,278012,-11021
200,Bodinayakanur,T.RAJA MOHAMED,IND,62,0,62,214795,278012,-11021
200,Bodinayakanur,A.ABTHAHIR,IND,53,1,54,214795,278012,-11021
200,Bodinayakanur,RAJA MOHAMED,IND,45,3,48,214795,278012,-11021
201,Cumbum,N.Ramakrishnan,DMK,102652,2148,104800,202275,285585,42413
201,Cumbum,Syedukhan.S.P.M,AIADMK,61978,409,62387,202275,285585,42413
201,Cumbum,Suresh.P,AMMK,14399,137,14536,202275,285585,42413
201,Cumbum,Anish Fathima. A,NTK,12123,224,12347,202275,285585,42413
201,Cumbum,Venkidesh.N,MNM,4582,65,4647,202275,285585,42413
201,Cumbum,NOTA,NOTA,1625,34,1659,202275,285585,42413
201,Cumbum,MUTHU MUNEESWARAN.M,IND,450,1,451,202275,285585,42413
201,Cumbum,SARAVANAN.S.R,IND,320,1,321,202275,285585,42413
201,Cumbum,KATHIRAVAN.S,New Generation People’s Party,232,4,236,202275,285585,42413
201,Cumbum,Prakash.P,IND,152,3,155,202275,285585,42413
201,Cumbum,Pandi Selvam.R,Anna Puratchi Thalaivar Amma Dravida Munnetra Kazhagam,148,3,151,202275,285585,42413
201,Cumbum,MUTHUSELVAM.G,IND,134,2,136,202275,285585,42413
201,Cumbum,RADHAKRISHNAN.K,Anaithu Makkal Puratchi Katchi,121,1,122,202275,285585,42413
201,Cumbum,Lal Bahdur Sasthri.V,My India Party,116,4,120,202275,285585,42413
201,Cumbum,MARIMUTHU.G,IND,105,1,106,202275,285585,42413
201,Cumbum,THAVIDHU RAJA. A,IND,99,2,101,202275,285585,42413
202,Rajapalayam,THANGAPANDIAN S.,DMK,72712,1446,74158,178708,238726,3898
202,Rajapalayam,RAJENTHRABHALAJI K.T,AIADMK,69870,390,70260,178708,238726,3898
202,Rajapalayam,JEYARAJ V.,NTK,15448,145,15593,178708,238726,3898
202,Rajapalayam,KALIMUTHU K.,AMMK,7607,53,7660,178708,238726,3898
202,Rajapalayam,VIVEKANANTHAN S.,MNM,4023,36,4059,178708,238726,3898
202,Rajapalayam,AYYAR V.K.,PT,3348,40,3388,178708,238726,3898
202,Rajapalayam,NOTA,NOTA,1869,6,1875,178708,238726,3898
202,Rajapalayam,MANIKUMAR M.,IND,546,2,548,178708,238726,3898
202,Rajapalayam,JEYAPRAKASH I.,IND,335,1,336,178708,238726,3898
202,Rajapalayam,THANGAPANDI S.,IND,261,3,264,178708,238726,3898
202,Rajapalayam,VIJAYAKUMAR E.,IND,140,0,140,178708,238726,3898
202,Rajapalayam,KALIMUTHU K.,IND,120,0,120,178708,238726,3898
202,Rajapalayam,THANGAPANDI B.,IND,111,1,112,178708,238726,3898
202,Rajapalayam,DHARMALINGAM K.,Republican Party of India (Athawale),106,3,109,178708,238726,3898
202,Rajapalayam,SELVARAJ G.,IND,84,2,86,178708,238726,3898
203,Srivilliputhur,"MANRAJ, E.M.",AIADMK,70081,394,70475,185039,249582,-12738
203,Srivilliputhur,"MADHAVARAO, P.S.W.",INC,56450,1287,57737,185039,249582,-12738
203,Srivilliputhur,"SANGEETHAPRIYA, S.",AMMK,23479,203,23682,185039,249582,-12738
203,Srivilliputhur,"ABINAYA, B.",NTK,20038,310,20348,185039,249582,-12738
203,Srivilliputhur,"SHANTHI, S.",PT,4917,68,4985,185039,249582,-12738
203,Srivilliputhur,"GURUVAIYA, K.",MNM,3468,44,3512,185039,249582,-12738
203,Srivilliputhur,NOTA,NOTA,1642,24,1666,185039,249582,-12738
203,Srivilliputhur,"IRULANDI, Dr. V.",Tamil Nadu Ilangyar Katchi,935,7,942,185039,249582,-12738
203,Srivilliputhur,"MUTHULAKSHMI,R.",IND,362,1,363,185039,249582,-12738
203,Srivilliputhur,"KANNAN, A.",IND,237,1,238,185039,249582,-12738
203,Srivilliputhur,"PANDIYARAJ, K.",Anaithu Makkal Puratchi Katchi,209,0,209,185039,249582,-12738
203,Srivilliputhur,"PRABHAKARAN, P.",IND,201,1,202,185039,249582,-12738
203,Srivilliputhur,"MAHALAKSHMI, M.",IND,189,2,191,185039,249582,-12738
203,Srivilliputhur,"VEERAPANDI, K.",My India Party,175,2,177,185039,249582,-12738
203,Srivilliputhur,"THAMARAISELVAM, K.",IND,163,1,164,185039,249582,-12738
203,Srivilliputhur,"GURUVAIYA, G.",IND,148,0,148,185039,249582,-12738
204,Sattur,"RAGHURAMAN,  A.R.R.",DMK,72949,1225,74174,191783,251510,11179
204,Sattur,"RAVICHANDHRAN, R.K.",AIADMK,62701,294,62995,191783,251510,11179
204,Sattur,"RAJAVARMAN, M.S.R.",AMMK,32693,223,32916,191783,251510,11179
204,Sattur,"PANDI, K.",NTK,12478,148,12626,191783,251510,11179
204,Sattur,"BHARATHI, M.",Indiya Jananayaka Katchi,1722,29,1751,191783,251510,11179
204,Sattur,"MARIKANNAN, G.",PT,1584,15,1599,191783,251510,11179
204,Sattur,NOTA,NOTA,1280,17,1297,191783,251510,11179
204,Sattur,"SARAVANAKUMAR, M.",IND,634,1,635,191783,251510,11179
204,Sattur,"SUBRAMANIAN, S.",IND,551,0,551,191783,251510,11179
204,Sattur,"ANGUSAMY,  S.",Anaithu Makkal Puratchi Katchi,411,3,414,191783,251510,11179
204,Sattur,"SENTHUR PANDIAN, R.",IND,405,1,406,191783,251510,11179
204,Sattur,"CHELLAPANDIAN,  P.",IND,368,1,369,191783,251510,11179
204,Sattur,"RAGU, B.",IND,331,1,332,191783,251510,11179
204,Sattur,"RAMESH, A.",IND,210,0,210,191783,251510,11179
204,Sattur,"RAJKUMAR, R.",My India Party,186,2,188,191783,251510,11179
204,Sattur,"JEYAGANESH, K.",Veerath Thiyagi Viswanathadoss Thozhilalarkal Katchi,166,0,166,191783,251510,11179
204,Sattur,"BALAMURUGAN, K.",IND,156,1,157,191783,251510,11179
204,Sattur,"SUBBURAMAN, P.",All India MGR Makkal Munnetra Kazhagam,153,3,156,191783,251510,11179
204,Sattur,"KARUTHAPANDIAN, S.",IND,136,0,136,191783,251510,11179
204,Sattur,"MARIAPPAN, M.",IND,123,1,124,191783,251510,11179
204,Sattur,"DHAMODHARAN,  S.",IND,118,1,119,191783,251510,11179
204,Sattur,"PALANICHAMY, P.",Bahujan Dravida Party,96,1,97,191783,251510,11179
204,Sattur,"GURUSAMY, P.",IND,94,0,94,191783,251510,11179
204,Sattur,"BALA SUBRAMANIAN, R.",IND,61,1,62,191783,251510,11179
204,Sattur,"PRABAKARAN, J.",IND,60,0,60,191783,251510,11179
204,Sattur,"ANTHONYRAJ,  A.",IND,57,0,57,191783,251510,11179
204,Sattur,"MANOHARAN, V.",IND,51,0,51,191783,251510,11179
204,Sattur,"MAHESKUMAR, M",IND,41,0,41,191783,251510,11179
205,Sivakasi,Ashokan.G,INC,77788,1159,78947,185047,260944,17319
205,Sivakasi,Lakshmi Ganesan,AIADMK,61367,261,61628,185047,260944,17319
205,Sivakasi,Kanagapriya.R,NTK,20754,111,20865,185047,260944,17319
205,Sivakasi,Samikkalai.G,AMMK,9751,142,9893,185047,260944,17319
205,Sivakasi,Mugunthan.S,MNM,6053,37,6090,185047,260944,17319
205,Sivakasi,NOTA,NOTA,1709,18,1727,185047,260944,17319
205,Sivakasi,LAKSHMANAN.E,IND,1410,20,1430,185047,260944,17319
205,Sivakasi,KESAVAKUMAR.D,IND,442,0,442,185047,260944,17319
205,Sivakasi,Ananthalakshmi,BSP,432,6,438,185047,260944,17319
205,Sivakasi,KANNAN.K,Veerath Thiyagi Viswanathadoss Thozhilalarkal Katchi,423,3,426,185047,260944,17319
205,Sivakasi,Balakrishnan.N,IND,405,9,414,185047,260944,17319
205,Sivakasi,DHARMALINGAM.M,IND,330,0,330,185047,260944,17319
205,Sivakasi,Karthik.N,IND,319,0,319,185047,260944,17319
205,Sivakasi,KARUPPASAMY.S,Anaithu Makkal Puratchi Katchi,314,2,316,185047,260944,17319
205,Sivakasi,VINOTHKUMAR.M,IND,245,0,245,185047,260944,17319
205,Sivakasi,Thangaraj.S,IND,233,1,234,185047,260944,17319
205,Sivakasi,MARIMUTHU.M,IND,220,1,221,185047,260944,17319
205,Sivakasi,KALYANASUNDARI.M,My India Party,188,3,191,185047,260944,17319
205,Sivakasi,GANESAN.R,IND,151,1,152,185047,260944,17319
205,Sivakasi,Anbalagan.P,IND,125,1,126,185047,260944,17319
205,Sivakasi,Pandiarajan.S,IND,113,1,114,185047,260944,17319
205,Sivakasi,MGR NAMBBI,All India MGR Makkal Munnetra Kazhagam,107,0,107,185047,260944,17319
205,Sivakasi,MAYILVAGANAN.G,IND,100,1,101,185047,260944,17319
205,Sivakasi,Ashokkumar.C,IND,86,2,88,185047,260944,17319
205,Sivakasi,JEEVANANTHAM.G,Republican Party of India (Athawale),77,1,78,185047,260944,17319
205,Sivakasi,JOYSMARY.T,IND,64,0,64,185047,260944,17319
205,Sivakasi,PALANICHAMY.P,Bahujan Dravida Party,61,0,61,185047,260944,17319
206,Virudhunagar,SEENIVASAN A.R.R,DMK,71909,1388,73297,161717,223542,21339
206,Virudhunagar,PANDURANGAN G,BJP,51502,456,51958,161717,223542,21339
206,Virudhunagar,SELVAKUMAR V.R,NTK,14162,149,14311,161717,223542,21339
206,Virudhunagar,THANGARAJ M,AMMK,10642,141,10783,161717,223542,21339
206,Virudhunagar,MANIMARAN N,All India Samathuva Makhal Katchi,4996,58,5054,161717,223542,21339
206,Virudhunagar,NOTA,NOTA,1556,14,1570,161717,223542,21339
206,Virudhunagar,GUNASEKARAN G,IND,1377,29,1406,161717,223542,21339
206,Virudhunagar,PUNGAN K,IND,758,1,759,161717,223542,21339
206,Virudhunagar,SUYAMBULINGAM L,Naam Indiar Party,587,3,590,161717,223542,21339
206,Virudhunagar,RAMARAJ C,IND,463,2,465,161717,223542,21339
206,Virudhunagar,VELUCHAMY S,IND,328,0,328,161717,223542,21339
206,Virudhunagar,PANDURENGAN T,IND,279,3,282,161717,223542,21339
206,Virudhunagar,SHIBI B,IND,261,3,264,161717,223542,21339
206,Virudhunagar,VIKRAMAN N,Desa Makkal Munnetrak Kazhgam,200,0,200,161717,223542,21339
206,Virudhunagar,DHAMOTHARAN R,IND,119,0,119,161717,223542,21339
206,Virudhunagar,THANGARAJ R,IND,93,0,93,161717,223542,21339
206,Virudhunagar,THANGAPANDI N,IND,85,4,89,161717,223542,21339
206,Virudhunagar,KARUPPIAH P,IND,84,1,85,161717,223542,21339
206,Virudhunagar,GURUNATHAN G,IND,64,0,64,161717,223542,21339
207,Aruppukkottai,K.K.S.S.R.RAMACHANDRAN,DMK,88928,2112,91040,171201,222988,39034
207,Aruppukkottai,VAIGAICHELVAN,AIADMK,51614,392,52006,171201,222988,39034
207,Aruppukkottai,UMA,NTK,12271,121,12392,171201,222988,39034
207,Aruppukkottai,V.UMADEVI,MNM,7550,88,7638,171201,222988,39034
207,Aruppukkottai,R.RAMESH,DMDK,2505,27,2532,171201,222988,39034
207,Aruppukkottai,NOTA,NOTA,1316,7,1323,171201,222988,39034
207,Aruppukkottai,K. BOOMINATHAN,IND,630,0,630,171201,222988,39034
207,Aruppukkottai,M.KARUPPASAMY,PT,460,18,478,171201,222988,39034
207,Aruppukkottai,P.PRASANTH,IND,436,0,436,171201,222988,39034
207,Aruppukkottai,THANGAPANDIAN,IND,425,1,426,171201,222988,39034
207,Aruppukkottai,LINGAPANDI,IND,419,0,419,171201,222988,39034
207,Aruppukkottai,G.SUBBURAJ,BSP,270,2,272,171201,222988,39034
207,Aruppukkottai,V. POORNISHA,IND,217,2,219,171201,222988,39034
207,Aruppukkottai,S.MANIVANNAN,IND,190,0,190,171201,222988,39034
207,Aruppukkottai,S.RAMACHANDRAN,IND,189,0,189,171201,222988,39034
207,Aruppukkottai,M MUTHUMARIAPPAN,IND,128,0,128,171201,222988,39034
207,Aruppukkottai,Ponmuniasamy,IND,118,0,118,171201,222988,39034
207,Aruppukkottai,DHANASEKARAPANDIAN,IND,76,0,76,171201,222988,39034
207,Aruppukkottai,E.RAMACHANDRAN,IND,72,0,72,171201,222988,39034
207,Aruppukkottai,R.RAMACHANDRAN,IND,71,0,71,171201,222988,39034
207,Aruppukkottai,R.S.RAMACHANDRAN,IND,67,0,67,171201,222988,39034
207,Aruppukkottai,THANGA VADIVEL.A.N,IND,61,1,62,171201,222988,39034
207,Aruppukkottai,G.RAMACHANDRAN,IND,60,0,60,171201,222988,39034
207,Aruppukkottai,VIJAYAKUMAR,IND,60,0,60,171201,222988,39034
207,Aruppukkottai,S.DEENATHAYALAN,Anaithu Makkal Puratchi Katchi,58,0,58,171201,222988,39034
207,Aruppukkottai,G.RANJITH,IND,57,0,57,171201,222988,39034
207,Aruppukkottai,A.P.S.JOHNSON,My India Party,55,2,57,171201,222988,39034
207,Aruppukkottai,S.PANDIYAN,Bahujan Dravida Party,48,0,48,171201,222988,39034
207,Aruppukkottai,T.RAMACHANDRAN,IND,39,0,39,171201,222988,39034
207,Aruppukkottai,VENKATESAN,IND,38,0,38,171201,222988,39034
208,Tiruchuli,THANGAM THENARASU,DMK,101016,1209,102225,172811,220729,60992
208,Tiruchuli,RAJASEKAR S,AIADMK,41087,146,41233,172811,220729,60992
208,Tiruchuli,ANANDHAJOTHI A,NTK,13654,133,13787,172811,220729,60992
208,Tiruchuli,SIVASAMY K K,AMMK,6399,42,6441,172811,220729,60992
208,Tiruchuli,ARUNKUMAR V,IND,2491,1,2492,172811,220729,60992
208,Tiruchuli,MURUGAN S,MNM,1338,18,1356,172811,220729,60992
208,Tiruchuli,ADAIKALAM R,IND,896,2,898,172811,220729,60992
208,Tiruchuli,NOTA,NOTA,734,6,740,172811,220729,60992
208,Tiruchuli,RAMATHILAGAM A,IND,683,1,684,172811,220729,60992
208,Tiruchuli,THIRUMURUGAN PALANISAMY K,PT,586,7,593,172811,220729,60992
208,Tiruchuli,MALAIALAGU M,IND,566,0,566,172811,220729,60992
208,Tiruchuli,THIRUMURUGAN G,IND,480,0,480,172811,220729,60992
208,Tiruchuli,ADVOCATE. THANGAPANDIAN M,IND,357,8,365,172811,220729,60992
208,Tiruchuli,RAJANGAM C,IND,349,0,349,172811,220729,60992
208,Tiruchuli,RAJENDRAN R,IND,137,0,137,172811,220729,60992
208,Tiruchuli,INDIRA B,IND,123,1,124,172811,220729,60992
208,Tiruchuli,HARIKRISHNAN K,IND,108,0,108,172811,220729,60992
208,Tiruchuli,MANIVASAGAM S,Bahujan Dravida Party,70,0,70,172811,220729,60992
208,Tiruchuli,SETHURAMALINGAM S,IND,65,0,65,172811,220729,60992
208,Tiruchuli,CHENNAKESAVAN P,IND,52,0,52,172811,220729,60992
208,Tiruchuli,KALIMUTHU S,IND,46,0,46,172811,220729,60992
209,Paramakudi,MURUGESAN S,DMK,83016,1848,84864,182158,254417,13285
209,Paramakudi,SADHAN PRABHAKAR N,AIADMK,70488,1091,71579,182158,254417,13285
209,Paramakudi,SASIKALA S,NTK,16262,168,16430,182158,254417,13285
209,Paramakudi,KARUPPU RAJA M,MNM,3447,41,3488,182158,254417,13285
209,Paramakudi,SELVI U,DMDK,1988,21,2009,182158,254417,13285
209,Paramakudi,NOTA,NOTA,1242,16,1258,182158,254417,13285
209,Paramakudi,MURUKESAN K,IND,684,3,687,182158,254417,13285
209,Paramakudi,GOVINDAN V,BSP,416,9,425,182158,254417,13285
209,Paramakudi,RAJIV GANDHI K,IND,350,4,354,182158,254417,13285
209,Paramakudi,UDHAYAKUMAR M,IND,208,0,208,182158,254417,13285
209,Paramakudi,BALAMURUGAN S,IND,196,2,198,182158,254417,13285
209,Paramakudi,PARTHASARATHI M,My India Party,187,1,188,182158,254417,13285
209,Paramakudi,RAMAPANDI C,IND,184,2,186,182158,254417,13285
209,Paramakudi,RAVISANKAR V,IND,109,0,109,182158,254417,13285
209,Paramakudi,UDAYAKUMAR,IND,96,0,96,182158,254417,13285
209,Paramakudi,KUMAR S,IND,78,1,79,182158,254417,13285
210,Tiruvadanai,KARUMANICKAM,INC,78415,949,79364,201815,287891,13852
210,Tiruvadanai,K C ANIMUTHU,AIADMK,65049,463,65512,201815,287891,13852
210,Tiruvadanai,ANANDH N,AMMK,33038,388,33426,201815,287891,13852
210,Tiruvadanai,JAWAHAR,NTK,16403,98,16501,201815,287891,13852
210,Tiruvadanai,SATHYARAJ,MNM,2189,19,2208,201815,287891,13852
210,Tiruvadanai,NOTA,NOTA,765,3,768,201815,287891,13852
210,Tiruvadanai,ANBUBAGURUDEEN N,Nationalist Congress Party,621,8,629,201815,287891,13852
210,Tiruvadanai,RAMALINGAM,BSP,605,5,610,201815,287891,13852
210,Tiruvadanai,PERUMAL,IND,517,5,522,201815,287891,13852
210,Tiruvadanai,MANIKANDAN,IND,410,0,410,201815,287891,13852
210,Tiruvadanai,ANANTHARAJ S,My India Party,399,0,399,201815,287891,13852
210,Tiruvadanai,SURIYA PRAKASH,IND,385,0,385,201815,287891,13852
210,Tiruvadanai,MANI,IND,382,0,382,201815,287891,13852
210,Tiruvadanai,PRAVEEN,IND,273,1,274,201815,287891,13852
210,Tiruvadanai,SIKKANDAR,IND,262,0,262,201815,287891,13852
210,Tiruvadanai,PRADEEP,IND,163,0,163,201815,287891,13852
211,Ramanathapuram,KATHARBATCHA MUTHURAMALINGAM,DMK,109712,1370,111082,214098,306388,50479
211,Ramanathapuram,D.KUPPURAMU,BJP,60262,341,60603,214098,306388,50479
211,Ramanathapuram,K.ILANGO,NTK,16960,86,17046,214098,306388,50479
211,Ramanathapuram,P.MALAICHAMY,IND,10808,14,10822,214098,306388,50479
211,Ramanathapuram,G.MUNIYASAMY,AMMK,6710,50,6760,214098,306388,50479
211,Ramanathapuram,K.P SARAVANAN,MNM,1962,23,1985,214098,306388,50479
211,Ramanathapuram,E VINOTH,IND,1216,0,1216,214098,306388,50479
211,Ramanathapuram,SURYAPRAKASH,IND,1000,2,1002,214098,306388,50479
211,Ramanathapuram,NOTA,NOTA,747,6,753,214098,306388,50479
211,Ramanathapuram,ALLAPICHAI,BSP,634,2,636,214098,306388,50479
211,Ramanathapuram,MISRA G,IND,493,2,495,214098,306388,50479
211,Ramanathapuram,AMUTHAN,Namadhu Makkal Katchi,382,1,383,214098,306388,50479
211,Ramanathapuram,B VIJAYAPRAKASH,IND,343,0,343,214098,306388,50479
211,Ramanathapuram,K.KURUNTHAPPAN,IND,245,1,246,214098,306388,50479
211,Ramanathapuram,S.SURESH,IND,190,0,190,214098,306388,50479
211,Ramanathapuram,V.JAYAPRAKASH,My India Party,133,0,133,214098,306388,50479
211,Ramanathapuram,SALEEM,IND,125,3,128,214098,306388,50479
211,Ramanathapuram,N MUNIYASAMI,IND,119,0,119,214098,306388,50479
211,Ramanathapuram,ASANALI,IND,77,1,78,214098,306388,50479
211,Ramanathapuram,R.S.WILHELM BENJAMIN ANAND,Bahujan Dravida Party,77,1,78,214098,306388,50479
212,Mudhukulathur,R.S.RAJAKANNAPPAN,DMK,100328,1573,101901,221213,308940,20721
212,Mudhukulathur,KEERTHIKA,AIADMK,80166,1014,81180,221213,308940,20721
212,Mudhukulathur,M.MURUGAN,AMMK,19403,266,19669,221213,308940,20721
212,Mudhukulathur,R.RAHMADNISHA,NTK,11099,145,11244,221213,308940,20721
212,Mudhukulathur,C.NAVAPANNEERSELVAM,MNM,923,20,943,221213,308940,20721
212,Mudhukulathur,K.SATHISH,IND,807,6,813,221213,308940,20721
212,Mudhukulathur,G.M.SENTHILMURUGAN,IND,708,5,713,221213,308940,20721
212,Mudhukulathur,A.SARAVANAKUMAR,Naam Indiar Party,609,5,614,221213,308940,20721
212,Mudhukulathur,S.PRABAKARAN,IND,546,2,548,221213,308940,20721
212,Mudhukulathur,N.SIVANANDAM,BSP,533,2,535,221213,308940,20721
212,Mudhukulathur,NOTA,NOTA,521,2,523,221213,308940,20721
212,Mudhukulathur,C.MALAISELVAM,PT,383,10,393,221213,308940,20721
212,Mudhukulathur,K.RAMACHANDRAN,IND,390,0,390,221213,308940,20721
212,Mudhukulathur,K.MURUGAN,IND,327,0,327,221213,308940,20721
212,Mudhukulathur,K.BOOMIRAJAN YADAV,Tamilaga Makkal Thannurimai Katchi,212,2,214,221213,308940,20721
212,Mudhukulathur,DEVA SITHAM.I,IND,199,5,204,221213,308940,20721
212,Mudhukulathur,S.IMMANUVEL SEKAR,IND,197,1,198,221213,308940,20721
212,Mudhukulathur,M.KARTHICK,IND,140,1,141,221213,308940,20721
212,Mudhukulathur,K.PANCHATCHARAM,My India Party,133,1,134,221213,308940,20721
212,Mudhukulathur,T.AZHAKUMALAI KUMARAN,IND,127,4,131,221213,308940,20721
212,Mudhukulathur,S.RAJA,People's Party of India(secular),114,0,114,221213,308940,20721
212,Mudhukulathur,K.RAJAKUMAR,IND,109,0,109,221213,308940,20721
212,Mudhukulathur,P.MURUGAN,IND,92,1,93,221213,308940,20721
212,Mudhukulathur,E.MOHAN,IND,82,0,82,221213,308940,20721
213,Vilathikulam,MARKANDAYAN V,DMK,89130,1218,90348,167169,215550,38549
213,Vilathikulam,CHINNAPPAN P,AIADMK,51237,562,51799,167169,215550,38549
213,Vilathikulam,BALAJI R,NTK,11697,131,11828,167169,215550,38549
213,Vilathikulam,SEENI SELVI K,AMMK,6591,66,6657,167169,215550,38549
213,Vilathikulam,WILSON X,MNM,1511,9,1520,167169,215550,38549
213,Vilathikulam,MUTHUKUMAR C,PT,1029,26,1055,167169,215550,38549
213,Vilathikulam,NOTA,NOTA,1017,19,1036,167169,215550,38549
213,Vilathikulam,KARUPPASAMY K,Naam Indiar Party,610,3,613,167169,215550,38549
213,Vilathikulam,MANIKKARAJ A,BSP,480,7,487,167169,215550,38549
213,Vilathikulam,MARIMUTHU S,South India Forward Bloc,398,6,404,167169,215550,38549
213,Vilathikulam,MURUGANANTHAM M,IND,347,1,348,167169,215550,38549
213,Vilathikulam,CHELLADURAI S,IND,310,2,312,167169,215550,38549
213,Vilathikulam,ARUMUGAM S,IND,272,0,272,167169,215550,38549
213,Vilathikulam,ARUMUGAPERUMAL K,IND,263,5,268,167169,215550,38549
213,Vilathikulam,GANDHI M,Bahujan Dravida Party,119,2,121,167169,215550,38549
213,Vilathikulam,RAJAMANI P,IND,101,0,101,167169,215550,38549
214,Thoothukkudi,P.Geetha Jeevan,DMK,90206,2108,92314,188407,284189,50310
214,Thoothukkudi,SDR Vijayaseelan,AIADMK,41621,383,42004,188407,284189,50310
214,Thoothukkudi,V.Velraj,NTK,30747,190,30937,188407,284189,50310
214,Thoothukkudi,N.Sundar,MNM,10475,59,10534,188407,284189,50310
214,Thoothukkudi,U.Chandran,DMDK,4011,29,4040,188407,284189,50310
214,Thoothukkudi,J.Sivaneswaran,IND,2849,17,2866,188407,284189,50310
214,Thoothukkudi,NOTA,NOTA,1539,30,1569,188407,284189,50310
214,Thoothukkudi,S.V.Rajasekar,United States of India Party,914,1,915,188407,284189,50310
214,Thoothukkudi,L.Maria Deva Sahaya Johny,IND,442,4,446,188407,284189,50310
214,Thoothukkudi,A.Ashok Kumar,BSP,432,4,436,188407,284189,50310
214,Thoothukkudi,A.Rajavel,IND,278,4,282,188407,284189,50310
214,Thoothukkudi,G.Selvavinayagam,Veerath Thiyagi Viswanathadoss Thozhilalarkal Katchi,268,1,269,188407,284189,50310
214,Thoothukkudi,S.Krishnan,IND,182,0,182,188407,284189,50310
214,Thoothukkudi,J.Alldrin Airmarshal Thayaram,IND,166,1,167,188407,284189,50310
214,Thoothukkudi,A.Jeyalalitha,IND,162,1,163,188407,284189,50310
214,Thoothukkudi,S.Subash,Republican Party of India (Athawale),159,2,161,188407,284189,50310
214,Thoothukkudi,J.Arun Nehruraj,IND,142,0,142,188407,284189,50310
214,Thoothukkudi,J.samuvel,IND,138,0,138,188407,284189,50310
214,Thoothukkudi,N.Balasubramanian,Anna Puratchi Thalaivar Amma Dravida Munnetra Kazhagam,126,1,127,188407,284189,50310
214,Thoothukkudi,K.Subramani,Shiv Sena,124,0,124,188407,284189,50310
214,Thoothukkudi,C.Ganesh Ayyadurai,IND,115,1,116,188407,284189,50310
214,Thoothukkudi,Mannar Maharajan,Bahujan Dravida Party,93,0,93,188407,284189,50310
214,Thoothukkudi,Ramagunaseelan,IND,88,0,88,188407,284189,50310
214,Thoothukkudi,S.Balasundram,IND,87,0,87,188407,284189,50310
214,Thoothukkudi,G.Selvam,IND,75,0,75,188407,284189,50310
214,Thoothukkudi,M.Lingaraja,IND,70,0,70,188407,284189,50310
214,Thoothukkudi,A.Mohamed Imran Arabi,IND,60,2,62,188407,284189,50310
215,Tiruchendur,Anitha R. Radhakrishnan,DMK,86162,2112,88274,174536,243386,25263
215,Tiruchendur,Radhakrishnan M,AIADMK,62420,591,63011,174536,243386,25263
215,Tiruchendur,Gloriyan S,NTK,14963,100,15063,174536,243386,25263
215,Tiruchendur,Vadamalaipandian S,AMMK,3730,36,3766,174536,243386,25263
215,Tiruchendur,Jayanthi M,MNM,1949,16,1965,174536,243386,25263
215,Tiruchendur,NOTA,NOTA,1040,11,1051,174536,243386,25263
215,Tiruchendur,Rooswelt X,Naam Indiar Party,238,1,239,174536,243386,25263
215,Tiruchendur,Baskar C,IND,195,1,196,174536,243386,25263
215,Tiruchendur,Pon Rathna Selvan S,IND,195,1,196,174536,243386,25263
215,Tiruchendur,Senthilkumar S,IND,177,0,177,174536,243386,25263
215,Tiruchendur,Shaik Abdul Kader P.S.J,IND,136,0,136,174536,243386,25263
215,Tiruchendur,Kennady Babu K,Veerath Thiyagi Viswanathadoss Thozhilalarkal Katchi,128,1,129,174536,243386,25263
215,Tiruchendur,Arumugam S,IND,107,1,108,174536,243386,25263
215,Tiruchendur,Kalyanasundaram R,IND,90,2,92,174536,243386,25263
215,Tiruchendur,Perumal K,IND,73,0,73,174536,243386,25263
215,Tiruchendur,Essakki Muthu,IND,58,2,60,174536,243386,25263
216,Srivaikuntam,Amirtharaj .S,INC,75086,1757,76843,164386,223770,17372
216,Srivaikuntam,S.P.SHUNMUGANATHAN,AIADMK,58583,888,59471,164386,223770,17372
216,Srivaikuntam,P.Subbiah Pandian,NTK,12552,154,12706,164386,223770,17372
216,Srivaikuntam,ERAL S. RAMESH,AMMK,10074,129,10203,164386,223770,17372
216,Srivaikuntam,R.Chandra Sekar,MNM,1345,10,1355,164386,223770,17372
216,Srivaikuntam,NOTA,NOTA,749,7,756,164386,223770,17372
216,Srivaikuntam,Durai Singh J,IND,493,1,494,164386,223770,17372
216,Srivaikuntam,Arun B,PT,437,7,444,164386,223770,17372
216,Srivaikuntam,Esakki Raja K,IND,336,5,341,164386,223770,17372
216,Srivaikuntam,Sethuramalingam S,IND,311,1,312,164386,223770,17372
216,Srivaikuntam,Ponnudurai I,IND,297,0,297,164386,223770,17372
216,Srivaikuntam,SURESH PERUMAL S,Naam Indiar Party,232,1,233,164386,223770,17372
216,Srivaikuntam,Sudalaimuthu Perumal,IND,139,1,140,164386,223770,17372
216,Srivaikuntam,Joseph Leon,IND,126,5,131,164386,223770,17372
216,Srivaikuntam,Sankara Subramanian M,IND,129,0,129,164386,223770,17372
216,Srivaikuntam,Jegan,Anna Dravidar Kazhagam,104,2,106,164386,223770,17372
216,Srivaikuntam,Kirushnavel R,IND,103,0,103,164386,223770,17372
216,Srivaikuntam,Arulmathi Yesuvadiyal,Aanaithinthiya Jananayaka Pathukappu Kazhagam,95,1,96,164386,223770,17372
216,Srivaikuntam,SARAVANAN G,IND,79,1,80,164386,223770,17372
216,Srivaikuntam,Malaiandi R,IND,56,0,56,164386,223770,17372
216,Srivaikuntam,ALLWIN DURAISINGH P,IND,51,1,52,164386,223770,17372
216,Srivaikuntam,VINSTON ANTO S,IND,37,1,38,164386,223770,17372
217,Ottapidaram,SHUNMUGAIAH C,DMK,71605,1505,73110,177840,250080,8510
217,Ottapidaram,MOHAN P,AIADMK,63907,693,64600,177840,250080,8510
217,Ottapidaram,VAIKUNDAMARI M,NTK,22104,309,22413,177840,250080,8510
217,Ottapidaram,Dr.K.KRISHNASAMY,PT,6418,126,6544,177840,250080,8510
217,Ottapidaram,ARUMUGANAINAR S,DMDK,5276,51,5327,177840,250080,8510
217,Ottapidaram,ARUNADEVI R,Indiya Jananayaka Katchi,1890,23,1913,177840,250080,8510
217,Ottapidaram,NOTA,NOTA,1540,28,1568,177840,250080,8510
217,Ottapidaram,MURUGAN P,Naam Indiar Party,517,3,520,177840,250080,8510
217,Ottapidaram,SAMUTHIRAM P,IND,396,3,399,177840,250080,8510
217,Ottapidaram,M.A.DHARMAR,IND,318,2,320,177840,250080,8510
217,Ottapidaram,RAJ V,IND,315,1,316,177840,250080,8510
217,Ottapidaram,MAHARAJAN A,Bahujan Dravida Party,155,2,157,177840,250080,8510
217,Ottapidaram,ELAMBIRAI MANIMARAN P,IND,148,4,152,177840,250080,8510
217,Ottapidaram,SASI MURUGAN C,IND,133,0,133,177840,250080,8510
217,Ottapidaram,GUNASEKARAN,IND,97,3,100,177840,250080,8510
217,Ottapidaram,VELMURUGAN,IND,98,0,98,177840,250080,8510
217,Ottapidaram,KARUPPARAJA,IND,84,2,86,177840,250080,8510
217,Ottapidaram,GANESHKUMAR M,IND,83,1,84,177840,250080,8510
218,Kovilpatti,KADAMBUR RAJU,AIADMK,67970,586,68556,180928,263638,-31176
218,Kovilpatti,TTV DHINAKARAN,AMMK,55729,424,56153,180928,263638,-31176
218,Kovilpatti,K.Srinivasan,CPM,36234,1146,37380,180928,263638,-31176
218,Kovilpatti,M.Gomathi,NTK,9114,99,9213,180928,263638,-31176
218,Kovilpatti,K.Kathiravan,MNM,3628,39,3667,180928,263638,-31176
218,Kovilpatti,NOTA,NOTA,1106,18,1124,180928,263638,-31176
218,Kovilpatti,Athikaran @ Athikumar,IND,638,6,644,180928,263638,-31176
218,Kovilpatti,Rameshkannan,IND,498,0,498,180928,263638,-31176
218,Kovilpatti,Subash,IND,442,1,443,180928,263638,-31176
218,Kovilpatti,Sivasubramanian,IND,420,0,420,180928,263638,-31176
218,Kovilpatti,P.Gunasekaran,IND,405,7,412,180928,263638,-31176
218,Kovilpatti,A.Kaliraj,IND,315,0,315,180928,263638,-31176
218,Kovilpatti,K.Shanmugasundaram,Bahujan Dravida Party,244,2,246,180928,263638,-31176
218,Kovilpatti,M.G.R.Nambbi,All India MGR Makkal Munnetra Kazhagam,244,0,244,180928,263638,-31176
218,Kovilpatti,J.Ravisankar Jayachanthiran,IND,203,2,205,180928,263638,-31176
218,Kovilpatti,Ramachandiran.R,BSP,200,3,203,180928,263638,-31176
218,Kovilpatti,S.Udaiyar,Naam Indiar Party,175,0,175,180928,263638,-31176
218,Kovilpatti,A.PattuRani,IND,134,2,136,180928,263638,-31176
218,Kovilpatti,M.Marimuthu,IND,133,0,133,180928,263638,-31176
218,Kovilpatti,Kannan,IND,121,0,121,180928,263638,-31176
218,Kovilpatti,M.Ponnusamy,IND,118,2,120,180928,263638,-31176
218,Kovilpatti,Manthirasudamani,IND,103,1,104,180928,263638,-31176
218,Kovilpatti,RAJKUMAR POLIAH,Universal Brotherhood Movement,97,2,99,180928,263638,-31176
218,Kovilpatti,Renganayagalu,IND,90,0,90,180928,263638,-31176
218,Kovilpatti,K.Pandimuneeswari,IND,78,3,81,180928,263638,-31176
218,Kovilpatti,Raja,IND,79,1,80,180928,263638,-31176
218,Kovilpatti,P.Ramasamy,IND,66,0,66,180928,263638,-31176
219,Sankarankovil,RAJA E,DMK,70144,1203,71347,183338,252942,5297
219,Sankarankovil,RAJALAKSHMI V M,AIADMK,65677,373,66050,183338,252942,5297
219,Sankarankovil,ANNADURAI R,AMMK,22278,404,22682,183338,252942,5297
219,Sankarankovil,MAHENDRAKUMARI P,NTK,13683,168,13851,183338,252942,5297
219,Sankarankovil,PRABHU K,MNM,2319,19,2338,183338,252942,5297
219,Sankarankovil,NOTA,NOTA,1937,20,1957,183338,252942,5297
219,Sankarankovil,SUBRAMANIAM V,PT,1912,29,1941,183338,252942,5297
219,Sankarankovil,VALLIAMMAL M,IND,888,2,890,183338,252942,5297
219,Sankarankovil,VETRIMARAN A,IND,620,0,620,183338,252942,5297
219,Sankarankovil,KARUTHAPANDIYAN R,IND,408,0,408,183338,252942,5297
219,Sankarankovil,MUTHUKKUTTI S,IND,389,0,389,183338,252942,5297
219,Sankarankovil,GURURAJ P,IND,303,0,303,183338,252942,5297
219,Sankarankovil,PANEERSELVAM U,Tamizhaga Murpokku Makkal Katchi,186,1,187,183338,252942,5297
219,Sankarankovil,MATHANKUMAR K,My India Party,168,3,171,183338,252942,5297
219,Sankarankovil,GANESAN A,IND,106,1,107,183338,252942,5297
219,Sankarankovil,BALAMURUGESAN M,Bahujan Dravida Party,94,3,97,183338,252942,5297
220,Vasudevanallur,"SADHAN THIRUMALAIKUMAR, DOCTOR.T",DMK,67053,1677,68730,175881,240372,2367
220,Vasudevanallur,MANOHARAN A,AIADMK,65952,411,66363,175881,240372,2367
220,Vasudevanallur,MATHIVANAN S S,NTK,16545,186,16731,175881,240372,2367
220,Vasudevanallur,THANGARAJ S,AMMK,13194,182,13376,175881,240372,2367
220,Vasudevanallur,PETCHIAMMAL V,PT,3600,51,3651,175881,240372,2367
220,Vasudevanallur,NOTA,NOTA,2147,24,2171,175881,240372,2367
220,Vasudevanallur,CHINNASAMY M,MNM,2105,34,2139,175881,240372,2367
220,Vasudevanallur,ESWARAN M,New Generation People’s Party,789,6,795,175881,240372,2367
220,Vasudevanallur,RAMAMOORTHY P,IND,715,1,716,175881,240372,2367
220,Vasudevanallur,JAYAKUMAR P L A,Tamil Nadu Ilangyar Katchi,525,19,544,175881,240372,2367
220,Vasudevanallur,KARUPPASAMY K,My India Party,340,2,342,175881,240372,2367
220,Vasudevanallur,MUTHUPANDI G,IND,322,1,323,175881,240372,2367
221,Kadayanallur,C.KRISHNAMURALI,AIADMK,87900,574,88474,205374,288914,-24349
221,Kadayanallur,K.A.M.MUHAMMED ABUBACKER,IUML,63298,827,64125,205374,288914,-24349
221,Kadayanallur,S.AYYADURAIPANDIAN,AMMK,34047,169,34216,205374,288914,-24349
221,Kadayanallur,M.MUTHULAKSHMI,NTK,10052,84,10136,205374,288914,-24349
221,Kadayanallur,M.AMBIKADEVI,MNM,1756,22,1778,205374,288914,-24349
221,Kadayanallur,NOTA,NOTA,1047,9,1056,205374,288914,-24349
221,Kadayanallur,S.SEENIVASAN,IND,938,0,938,205374,288914,-24349
221,Kadayanallur,SIVASUBRAMANIYAN R,IND,666,6,672,205374,288914,-24349
221,Kadayanallur,VELAMMAL,IND,670,2,672,205374,288914,-24349
221,Kadayanallur,POOLOGARAJ R,IND,657,1,658,205374,288914,-24349
221,Kadayanallur,S.MURUGANANTHAM,IND,532,0,532,205374,288914,-24349
221,Kadayanallur,A.SANKAR,IND,413,0,413,205374,288914,-24349
221,Kadayanallur,S.RAJA RAM,New Generation People’s Party,313,5,318,205374,288914,-24349
221,Kadayanallur,M.AYYADURAI,IND,283,1,284,205374,288914,-24349
221,Kadayanallur,RAJA PONNUSAMY,IND,257,2,259,205374,288914,-24349
221,Kadayanallur,P.RAJI,IND,245,2,247,205374,288914,-24349
221,Kadayanallur,R.KRISHNAN,IND,126,0,126,205374,288914,-24349
221,Kadayanallur,A.GANESAN,IND,117,5,122,205374,288914,-24349
221,Kadayanallur,MARIDURAIPANDIAN,IND,96,0,96,205374,288914,-24349
221,Kadayanallur,AYYADURAI  R,IND,87,0,87,205374,288914,-24349
221,Kadayanallur,K.RADHA KRISHNAN,IND,84,1,85,205374,288914,-24349
221,Kadayanallur,AVANI RAJA.T,IND,80,0,80,205374,288914,-24349
222,Tenkasi,PALANI NADAR.S,INC,87706,1609,89315,214108,291529,370
222,Tenkasi,SELVA MOHANDAS PANDIAN.S,AIADMK,88271,674,88945,214108,291529,370
222,Tenkasi,VINCENTRAJ.R,NTK,15213,123,15336,214108,291529,370
222,Tenkasi,MOHAMED.S,AMMK,9839,105,9944,214108,291529,370
222,Tenkasi,THIRUMALAIMUTHU.R,MNM,2169,19,2188,214108,291529,370
222,Tenkasi,MADASAMY.A,IND,1974,4,1978,214108,291529,370
222,Tenkasi,NOTA,NOTA,1146,13,1159,214108,291529,370
222,Tenkasi,CHANDRASEGAR.S,PT,857,21,878,214108,291529,370
222,Tenkasi,UDHAYAKUMAR.K.M,Anna Dravidar Kazhagam,685,5,690,214108,291529,370
222,Tenkasi,RAMESH.R,IND,684,0,684,214108,291529,370
222,Tenkasi,PALANIMURUGAN.P,IND,627,1,628,214108,291529,370
222,Tenkasi,REEGANKUMAR. M,IND,495,0,495,214108,291529,370
222,Tenkasi,AROKKIYA PRABHU.J,IND,426,2,428,214108,291529,370
222,Tenkasi,JEGANATHAN.M,Anaithu Makkal Puratchi Katchi,409,7,416,214108,291529,370
222,Tenkasi,SELVAKUMAR.R,Naam Indiar Party,317,2,319,214108,291529,370
222,Tenkasi,DOCTOR. KARUPPASAMY.S,IND,214,2,216,214108,291529,370
222,Tenkasi,MUGUNDHAN.K,My India Party,194,1,195,214108,291529,370
222,Tenkasi,PALANIKUMAR.A,IND,174,1,175,214108,291529,370
222,Tenkasi,SURESHKUMAR.S,Anna Puratchi Thalaivar Amma Dravida Munnetra Kazhagam,119,0,119,214108,291529,370
223,Alangulam,PAUL MANOJ PANDIAN,AIADMK,73846,307,74153,203478,260143,-3539
223,Alangulam,DR.POONGOTHAI ALADI ARUNA,DMK,69325,1289,70614,203478,260143,-3539
223,Alangulam,HARI NADAR.A,IND,37603,124,37727,203478,260143,-3539
223,Alangulam,M.SANGEETHA ESAK,NTK,12396,123,12519,203478,260143,-3539
223,Alangulam,RAJENDRANATHAN,DMDK,2797,19,2816,203478,260143,-3539
223,Alangulam,NOTA,NOTA,1772,14,1786,203478,260143,-3539
223,Alangulam,S.SELVAKUMAR,MNM,1439,15,1454,203478,260143,-3539
223,Alangulam,A.UDHAYAKUMAR,PT,1098,7,1105,203478,260143,-3539
223,Alangulam,ARUNKUMAR.K,IND,492,0,492,203478,260143,-3539
223,Alangulam,K.SIVARAM,IND,435,1,436,203478,260143,-3539
223,Alangulam,S.SANKAR GANESH YADAV,IND,375,1,376,203478,260143,-3539
224,Tirunelveli,Nainar Nagenthran,BJP,91504,778,92282,197587,291159,-23107
224,Tirunelveli,"Lakshmanan,A.L.S.",DMK,68102,1073,69175,197587,291159,-23107
224,Tirunelveli,"Sathya,B.",NTK,18986,176,19162,197587,291159,-23107
224,Tirunelveli,"Mahesh Kannan,A.P.",AMMK,8807,104,8911,197587,291159,-23107
224,Tirunelveli,NOTA,NOTA,2074,17,2091,197587,291159,-23107
224,Tirunelveli,"Sivakumar,M.",IND,1375,37,1412,197587,291159,-23107
224,Tirunelveli,Srithar Rajan,IND,1336,6,1342,197587,291159,-23107
224,Tirunelveli,Kalanithy,BSP,646,8,654,197587,291159,-23107
224,Tirunelveli,"Sankarasubramanian,M.",IND,582,0,582,197587,291159,-23107
224,Tirunelveli,"Esakkimuthu,P.",IND,435,2,437,197587,291159,-23107
224,Tirunelveli,"Sundarraj,M.",CPI(ML)(L),412,3,415,197587,291159,-23107
224,Tirunelveli,"Murugan,V.",IND,339,3,342,197587,291159,-23107
224,Tirunelveli,"Raghavan,C.M.",IND,318,1,319,197587,291159,-23107
224,Tirunelveli,Sankar @ Sankaranarayanan,IND,264,0,264,197587,291159,-23107
224,Tirunelveli,"Murugan,R.",IND,197,2,199,197587,291159,-23107
225,Ambasamudram,E.SUBAYA,AIADMK,84665,546,85211,177681,244052,-16915
225,Ambasamudram,R.AVUDAIAPPAN,DMK,67267,1029,68296,177681,244052,-16915
225,Ambasamudram,SHENBAGA VALLI,NTK,13599,136,13735,177681,244052,-16915
225,Ambasamudram,C.RANI RANJITHAM,AMMK,4146,48,4194,177681,244052,-16915
225,Ambasamudram,C.GANESAN,MNM,2765,42,2807,177681,244052,-16915
225,Ambasamudram,NOTA,NOTA,1665,8,1673,177681,244052,-16915
225,Ambasamudram,MANIMARAN,BSP,505,4,509,177681,244052,-16915
225,Ambasamudram,J.RAJESH DHARMASINGH PANDIAN,IND,390,0,390,177681,244052,-16915
225,Ambasamudram,M.GAVASKAR,IND,310,5,315,177681,244052,-16915
225,Ambasamudram,S. LAKSHMANAN,Veerath Thiyagi Viswanathadoss Thozhilalarkal Katchi,178,0,178,177681,244052,-16915
225,Ambasamudram,S.GANESAN,IND,166,0,166,177681,244052,-16915
225,Ambasamudram,ARUNACHALAM,IND,117,2,119,177681,244052,-16915
225,Ambasamudram,ABDUL MAJEETH,IND,88,0,88,177681,244052,-16915
226,Palayamkottai,ABDUL WAHAB .M,DMK,86869,2248,89117,161091,271741,52141
226,Palayamkottai,GERALD .G,AIADMK,36393,583,36976,161091,271741,52141
226,Palayamkottai,MOHAMED MUBARAK .V.M.S.,SOCIAL DEMOCRATIC PARTY OF INDIA,12126,115,12241,161091,271741,52141
226,Palayamkottai,FATHIMA .A,NTK,11515,150,11665,161091,271741,52141
226,Palayamkottai,PREMNATH. D,MNM,8002,105,8107,161091,271741,52141
226,Palayamkottai,NOTA,NOTA,1620,27,1647,161091,271741,52141
226,Palayamkottai,SADAGOPAN .K,IND,387,8,395,161091,271741,52141
226,Palayamkottai,RAJA .S,Veerath Thiyagi Viswanathadoss Thozhilalarkal Katchi,294,4,298,161091,271741,52141
226,Palayamkottai,VEERASUBRAMANIYAN .S,Aanaithinthiya Jananayaka Pathukappu Kazhagam,226,5,231,161091,271741,52141
226,Palayamkottai,JOHN SAMUVEL JESUPATHAM .D,IND,209,3,212,161091,271741,52141
226,Palayamkottai,LEO INFANT RAJ .M,IND,195,7,202,161091,271741,52141
227,Nanguneri,RUBY R MANOHARAN,INC,74493,1409,75902,192522,276378,16486
227,Nanguneri,GANESARAJA,AIADMK,59045,371,59416,192522,276378,16486
227,Nanguneri,PARAMASIVA IYYAPPAN,AMMK,31708,162,31870,192522,276378,16486
227,Nanguneri,VEERAPANDI,NTK,17543,111,17654,192522,276378,16486
227,Nanguneri,NOTA,NOTA,1531,6,1537,192522,276378,16486
227,Nanguneri,KATHIRAVAN,IND,1151,3,1154,192522,276378,16486
227,Nanguneri,GNANA BALAJI,IND,806,7,813,192522,276378,16486
227,Nanguneri,SUBBULAKSHMI,BSP,697,3,700,192522,276378,16486
227,Nanguneri,ASHOK KUMAR,IND,619,6,625,192522,276378,16486
227,Nanguneri,KANDHAN,Anaithu Ulaga Tamilargal Munnetra Kalagam,495,2,497,192522,276378,16486
227,Nanguneri,LENIN,IND,449,5,454,192522,276378,16486
227,Nanguneri,SHUNMUGA SUNDARAM,Naam Indiar Party,441,0,441,192522,276378,16486
227,Nanguneri,MUTHURAJ,IND,434,2,436,192522,276378,16486
227,Nanguneri,KANDASAMY,IND,428,4,432,192522,276378,16486
227,Nanguneri,PRABAKARAN,Veerath Thiyagi Viswanathadoss Thozhilalarkal Katchi,429,1,430,192522,276378,16486
227,Nanguneri,MUTHUDURAI,IND,160,1,161,192522,276378,16486
228,Radhapuram,M.Appavu,DMK,80241,2090,82331,187310,269889,5925
228,Radhapuram,I.S.Inbadurai,AIADMK,75749,657,76406,187310,269889,5925
228,Radhapuram,R.Jesu Dhasan,NTK,19271,100,19371,187310,269889,5925
228,Radhapuram,K.Jeyabalan,DMDK,2409,23,2432,187310,269889,5925
228,Radhapuram,G.Deva Peran,IND,1221,3,1224,187310,269889,5925
228,Radhapuram,NOTA,NOTA,894,9,903,187310,269889,5925
228,Radhapuram,K.Subburaj,IND,518,0,518,187310,269889,5925
228,Radhapuram,R.Sudalaimani,IND,466,4,470,187310,269889,5925
228,Radhapuram,E.Esakkiammal,BSP,460,4,464,187310,269889,5925
228,Radhapuram,T.Sermadurai,IND,455,1,456,187310,269889,5925
228,Radhapuram,J.Jesu Rajendran,Naam Indiar Party,328,1,329,187310,269889,5925
228,Radhapuram,A.Kumar,IND,309,9,318,187310,269889,5925
228,Radhapuram,T.Muthu Selvi,IND,308,2,310,187310,269889,5925
228,Radhapuram,M.Chandran,Veerath Thiyagi Viswanathadoss Thozhilalarkal Katchi,291,4,295,187310,269889,5925
228,Radhapuram,N.Godfrey Washington Noble,Aanaithinthiya Jananayaka Pathukappu Kazhagam,235,0,235,187310,269889,5925
228,Radhapuram,T.Venus Veera Arasu,IND,222,2,224,187310,269889,5925
228,Radhapuram,N.Kannan,IND,191,2,193,187310,269889,5925
228,Radhapuram,M.Vijayakumar,IND,143,0,143,187310,269889,5925
228,Radhapuram,D.Arunraj,IND,139,0,139,187310,269889,5925
228,Radhapuram,M.Saswathan,IND,116,1,117,187310,269889,5925
228,Radhapuram,M.Antony Rossary,IND,98,0,98,187310,269889,5925
228,Radhapuram,D.Sheik Syed Ali,IND,95,0,95,187310,269889,5925
228,Radhapuram,S.Abinanth Ram,IND,68,1,69,187310,269889,5925
228,Radhapuram,S.Katteri Perumal,IND,59,0,59,187310,269889,5925
228,Radhapuram,T.Rethina Pandi,IND,59,0,59,187310,269889,5925
228,Radhapuram,S.Manikandan,IND,52,0,52,187310,269889,5925
229,Kanniyakumari,THALAVAI SUNDARAM N.,AIADMK,108136,1609,109745,224874,292443,-16213
229,Kanniyakumari,AUSTIN S.,DMK,91511,2021,93532,224874,292443,-16213
229,Kanniyakumari,SASIKALA  R.,NTK,14072,68,14140,224874,292443,-16213
229,Kanniyakumari,SELVAKUMAR  P.T.,MNM,3100,6,3106,224874,292443,-16213
229,Kanniyakumari,SENTHIL MURUGAN  P.,AMMK,1570,19,1589,224874,292443,-16213
229,Kanniyakumari,NOTA,NOTA,1092,4,1096,224874,292443,-16213
229,Kanniyakumari,SUTHARMAN C.J.,BSP,675,6,681,224874,292443,-16213
229,Kanniyakumari,AUGUSTIN A.,IND,445,1,446,224874,292443,-16213
229,Kanniyakumari,MANICKAVASAGAM PILLAI NA.,IND,141,1,142,224874,292443,-16213
229,Kanniyakumari,MAKESH N.,IND,115,4,119,224874,292443,-16213
229,Kanniyakumari,THANU NEELAN S.,IND,95,0,95,224874,292443,-16213
229,Kanniyakumari,SUBASH S.,IND,77,1,78,224874,292443,-16213
229,Kanniyakumari,CHELLIAH PILLAI I.,IND,55,0,55,224874,292443,-16213
229,Kanniyakumari,SUNDARA NATHAN Y.,IND,50,0,50,224874,292443,-16213
230,Nagercoil,Gandhi M.R.,BJP,87805,999,88804,184185,269410,-11669
230,Nagercoil,Suresh Rajan N.,DMK,75387,1748,77135,184185,269410,-11669
230,Nagercoil,Vijayaragavan,NTK,10666,87,10753,184185,269410,-11669
230,Nagercoil,Maria Jacob Stani Raja S.,MNM,4007,30,4037,184185,269410,-11669
230,Nagercoil,Ammu Anto I.,AMMK,1079,15,1094,184185,269410,-11669
230,Nagercoil,NOTA,NOTA,919,11,930,184185,269410,-11669
230,Nagercoil,Sunil Kumar S.,Anaithu Makkal Puratchi Katchi,314,1,315,184185,269410,-11669
230,Nagercoil,Bala Sivanesan J.,IND,238,4,242,184185,269410,-11669
230,Nagercoil,Gandhi Raj C.,IND,182,1,183,184185,269410,-11669
230,Nagercoil,Usha P.,IND,132,2,134,184185,269410,-11669
230,Nagercoil,Rathinam A.T.,IND,133,1,134,184185,269410,-11669
230,Nagercoil,Kannan M.,IND,102,1,103,184185,269410,-11669
230,Nagercoil,Pravin Raj P.,IND,97,0,97,184185,269410,-11669
230,Nagercoil,Mahizhchi P.,IND,80,1,81,184185,269410,-11669
230,Nagercoil,Gandhi L.,IND,73,0,73,184185,269410,-11669
230,Nagercoil,Satheesh Kumar D.,Anaithu Makkal Arasiyal Katchi,70,0,70,184185,269410,-11669
231,Colachel,Prince J.G.,INC,89121,1560,90681,182969,267268,24832
231,Colachel,Ramesh P.,BJP,65047,802,65849,182969,267268,24832
231,Colachel,Antony Aslin J.,NTK,18071,131,18202,182969,267268,24832
231,Colachel,Lathis Mary S.,MNM,2117,10,2127,182969,267268,24832
231,Colachel,Sivakumar M.,DMDK,1320,12,1332,182969,267268,24832
231,Colachel,Anthony Muthu S.M.,CPI(ML)(L),1203,15,1218,182969,267268,24832
231,Colachel,Krishna Kumar A.,Anaithu Makkal Puratchi Katchi,1143,2,1145,182969,267268,24832
231,Colachel,NOTA,NOTA,870,8,878,182969,267268,24832
231,Colachel,Anish K.M.,BSP,829,2,831,182969,267268,24832
231,Colachel,Vijayakumar R.,IND,270,2,272,182969,267268,24832
231,Colachel,Marystella R.,IND,201,0,201,182969,267268,24832
231,Colachel,"Mohammed Ali, Professor, S.",IND,130,0,130,182969,267268,24832
231,Colachel,Raja C.,Shiv Sena,103,0,103,182969,267268,24832
232,Padmanabhapuram,"Mano Thangaraj, T.",DMK,86193,1551,87744,170156,237139,26885
232,Padmanabhapuram,"John Thankam, D.",AIADMK,60100,759,60859,170156,237139,26885
232,Padmanabhapuram,Seelan,NTK,13709,190,13899,170156,237139,26885
232,Padmanabhapuram,"Jenkins, D.",AMMK,3192,42,3234,170156,237139,26885
232,Padmanabhapuram,"Latha, P.",BSP,1253,19,1272,170156,237139,26885
232,Padmanabhapuram,NOTA,NOTA,1023,13,1036,170156,237139,26885
232,Padmanabhapuram,"Jeyaraj, M.",MNM,962,19,981,170156,237139,26885
232,Padmanabhapuram,"SyedAli, A.",IND,321,3,324,170156,237139,26885
232,Padmanabhapuram,"Glory Selvi, T.",IND,262,9,271,170156,237139,26885
232,Padmanabhapuram,"Mathan, F.",IND,173,4,177,170156,237139,26885
232,Padmanabhapuram,"Robert Singh, I.",IND,175,0,175,170156,237139,26885
232,Padmanabhapuram,"Nagarajan, M.",IND,128,1,129,170156,237139,26885
232,Padmanabhapuram,"Anchalose, Y.",IND,55,0,55,170156,237139,26885
233,Vilavancode,VIJAYADHARANI S,INC,86227,1246,87473,167836,247496,28669
233,Vilavancode,JAYASEELAN R,BJP,58156,648,58804,167836,247496,28669
233,Vilavancode,MARY ADLIN,NTK,12120,172,12292,167836,247496,28669
233,Vilavancode,SAMUEL GEORGE KALAI ARASAR,IND,3492,49,3541,167836,247496,28669
233,Vilavancode,IDEN SONI L,DMDK,2415,32,2447,167836,247496,28669
233,Vilavancode,NOTA,NOTA,774,8,782,167836,247496,28669
233,Vilavancode,RAJAKUMAR R,MNM,626,11,637,167836,247496,28669
233,Vilavancode,AMOSE S,IND,431,5,436,167836,247496,28669
233,Vilavancode,VIJAYAKUMAR P,IND,293,1,294,167836,247496,28669
233,Vilavancode,VASANTHEESWARAN E,Ulaga Makkal Katchi,234,1,235,167836,247496,28669
233,Vilavancode,MOHAN KUMAR M,IND,198,0,198,167836,247496,28669
233,Vilavancode,SATHEESH S,IND,183,2,185,167836,247496,28669
233,Vilavancode,WILSON G,Shiv Sena,161,0,161,167836,247496,28669
233,Vilavancode,RAJA MURRUGAN K H,IND,150,0,150,167836,247496,28669
233,Vilavancode,MARIASELVAN Y,IND,122,0,122,167836,247496,28669
233,Vilavancode,RAJESH KUMAR S,National Democratic Party of South India,77,2,79,167836,247496,28669
234,Killiyoor,RAJESH KUMAR  S,INC,99393,2148,101541,169918,251430,55400
234,Killiyoor,JUDE DEV   K.V,AIADMK,45419,722,46141,169918,251430,55400
234,Killiyoor,PETER H,NTK,14328,189,14517,169918,251430,55400
234,Killiyoor,SIVAKUMAR  V,BSP,1571,25,1596,169918,251430,55400
234,Killiyoor,JAYARAJ E,Tamil Nadu Ilangyar Katchi,1429,14,1443,169918,251430,55400
234,Killiyoor,ANTONY  A,All India Samathuva Makhal Katchi,1205,9,1214,169918,251430,55400
234,Killiyoor,SEEMA  A,AMMK,1079,23,1102,169918,251430,55400
234,Killiyoor,NOTA,NOTA,747,7,754,169918,251430,55400
234,Killiyoor,SIVAN RAJ  K,IND,315,8,323,169918,251430,55400
234,Killiyoor,RAMESH RAJA KUMAR C,IND,275,3,278,169918,251430,55400
234,Killiyoor,JOHN BENADICT G,IND,233,2,235,169918,251430,55400
234,Killiyoor,ANCHALOSE R,IND,210,3,213,169918,251430,55400
234,Killiyoor,SHAJU SINGH M R,IND,211,2,213,169918,251430,55400
234,Killiyoor,VIJIKUMAR K,National Democratic Party of South India,184,2,186,169918,251430,55400
234,Killiyoor,THANKAPPAN C,Tamilnadu Mahatma Gandhi Makkal Katchi,159,3,162,169918,251430,55400
